Từ	Nghĩa
Abao (dt)	Ốc bươu.  
Abăn (dt)	Cái chăn (mền). Msăm abăn: đăp chăn; Abăn hmlei: Chăn bông.
Abŭ (dt)	Cái hũ.
Adei (dt)	Em. 
Adĕ (dt)	Hến. 
Adham (dt)	Một nhóm trong tộc người Êđê.
Adhan (dt)	Cành. Adhan kyâo: Cành cây.
Adhei (dt)	Trán. Adhei: Trán rộng.             
Adiê (dt)	Trời. Adiê hjan: Trời mưa.
Adiê không	Năng hạn.
Adiê tlam	Xế chiều.
Adih (đt)	Kia. Sang kâo ti anôk adih: Nhà tôi chỗ kia; Hruê aguah 
	Adih kâo đue# hiu: Sáng ngày kia tôi đi chơi.  
Adôk (đgt)	Còn. Kâo adôk prăk: Tôi còn tiền; Adôk hdyøp: Còn sống.
Adrăng (dt)	Rơm rạ. Mkăm adrăng: đống rơm.
Adring (dt)	Hiên nhà sàn. Amyø kâo [hu mdiê ti adring: Mẹ tôi phơi luôa ở hiên nhà sàn.
Adrŏk (dt)	Con cóc.
Aduôn (dt)	Bà (nội
Adŭ (dt)	1.Phòng. Adu\ pyøt: Phòng ngủ; Adu\ hriăm: Phòng học. 
	2. Lớp. Adu\ năm: Lớp 6; Adu\ pluh dua: Lớp 12. 
	3. Cái ô. Adu\ ju\: eø màu đen.
Adŭ bruă (dt)	Văn phòng.
Adŭ gĭt gai bruă kiă kriê (dt) 	 Phòng hành chính.
Adŭ tĭng yap (dt)	Phòng kế tín.
Adŭng (dt)	Mũi. {ăng adu\ng: Lỗ mũi.
Aê (dt)	Eøng (nội
Aê êa drao (dt)	Bác sĩ. Aê êa drao jing pô mdrao klei ruă kơ jih jang mnuih: Bác sĩ là người chữa bệnh cho mọi người.
Agam (tt)	Loạn luân. Klei ngă agam jing soh ho\ng klei bhiăn anak Êđê: Loạn luân là hành động vi phạm phong tục của người Êđê.
Agha (dt)	Rễ. Agha kram: Rễ tre.
Aguah (trạng từ)	Buổi sáng. Aguah ưm: Sáng sớm; Aguah mgi: Sáng mai; Aguah mbruê: Sáng hôm qua. 
Aguăt (dt)	Con bọ cạp. Aguăt du\] ruă snăk: Bọ cạp đốt rất đau.
Ah (hư từ)              	Ạ. Kâo thâo klei soh leh amyø ah: con biết lỗi rồi mẹ ạ.
Ai (dt)	Sức. Ai ktang: Sức mạnh.
Ai hriăm (dt)	Học lực.
Ai êwa (dt) (tt)	Khí thế
Ai mĭn (đgt)	Suy nghĩ. Tui si ai kâo myøn: Theo tôi nghĩ.
Ajĭk (dt)	Eùaúch. 
Ak (dt)	Con quạ. Ju\ mse\ si ak: đen như quạ.
Akăt (dt)	Bụi (khóm). Akăt kram: Bụi tre.
Akâo (đgt)	Xin. Akâo prăk: Xin tiền; Akâo êa mnăm: Xin nước uống.
Ala (dt)	Con răn. Ala knăl: Răn giun; Ala mtah: Răn lục.
Ala čar (dt)	Tổ quốc. Ala ]ar Việt Nam: Tổ quốc Việt Nam. 
Ala čar tač êngao (dt) 	Nước ngịi.
Alah (tt)	Lười biếng. Alah mă bruă: Lười làm việc; Mnuih alah: Người lười biếng.
Alah alan (tt)	Uể oải. Mă bruă alah alan: Làm việc uể oải.
Ală (dt)	Măt. Pyøt ală: Nhăm măt.
Ală kĭng (dt)	Kính. Truă ală kyøng: đeo kính.
Ală mmăt (tt)	Cận thị. Ală mmăt kjham: Măt cận thị nặng.
Alĕ, Aluê̆ (đgt)	Nhả.  Ale\ djah êhăng: Nhả bã trầu.
Alê (dt)	Le.
Alôk (đgt)	Lột. Alôk boh [ơr: Lột vỏ quả bơ.
Alum akâo (đgt)	Cầu xin. Alum akâo kơ aê êa drao đru mdrao brei anak kâo: Cầu xin bác sĩ cứu chữa con tôi.
Alum kkuh (đgt)	Kính thưa.
Alum mpŭ (đgt)	Trân trọng
Alŭ (dt)	Thôn
Alŭ wăl (dt)	Vùng.
Alŭ ƀuôn prŏng	Phố phường.
Alưñ (tt)	Gớm. Alưyû bưyû: Gớm giếc.
Am pul pui (dt) 	Bóng đèn. Am pul pui kmlă: Bóng điện.
Ama (dt)	Bố (cha).
Amai (dt)	Chị.
Amâo (pht)	Không. Amâo mâo: Không có; Kâo amâo mâo prăk: Tôi không có tiền; Amâo guôp: Không hợp.
Amâo dah (lt)	Hay (hoặc). Kâo amâo dah ih nao: Tôi hay anh đi.
Amâo dưi 	 
Amâo djŏ ai (tt)	Không vừa lòng. Aáu mă bruă amâo djo\ ai amyø ama: Nó làm việc không vừa lòng bố mẹ.
Amâo djŏ knŏng (trgt)	Chẳng những. Amâo djo\ kno\ng hriăm hră kriăng ôh
Amâo kpă (tt)	Bất chính. Klei ngă amâo kpă: Hành động bất chính. 
Amâo klă mngač (tt)	Bất minh. Mje\ mjuk amâo klă mnga]: Quan hệ bất minh.
Amâo răk (đgt)	Bất cứ
Amâo răk rai (hư từ)	Bất diệt. Klei đao\ knang amâo răk rai: Niềm tin bất diệt.
Amâo thâo knga (tt)	Vô ơn.: Người vô ơn.
Amâo mâo tŭ ư (đgt)	Phản đối. Tôi phản đối anh ta làm việc không đúng.
Amiêt (dt)	Cậu. Anei amiêt kâo: đây là cậu tôi.
Amĭ (dt)	Mẹ (má).
Amĭ ama hđeh (dt)	Phụ huynh.
Amlơ̆k (dt)	Cám. Amlơ\k ]iêm u\n: Cám lợn.
Amra (pht)	Sẽ. Kâo amra nao: Tôi sẽ đi.
Amrak (dt)	Con công. Rông amrak pioh dlăng: Nuôi công làm cảnh.
Amrê̆č (dt)	Eûoût. Sang kâo mâo pla amre#]: nhà tôi có trồng ớt.
Amung mtei (dt)	Buồng chuối. Amyø koh amung mtei: Mẹ chặt buồng chuối.
Amung mdiê (dt)	Bông luôa. 
Amung kngan (dt)	Mu tay.
Amung ŭn (dt)	Mõm lợn (heo).
Amuôn (dt)	Cháu (cháu với cậu
Ana 	I.(dt) cây. Ana kneh: cây mít. Ana truôl: cây ổi.
                                  	Ii.(tt) giống cái (từ dùng chỉ động vật giống cái). Uyõn ana: lợn nái; mnu\ ana: gà mái.
Anak (dt)	Con (dùng cho người). 
Anak ală (dt)	Con ngươi.
Anak ĭ (dt)	Trẻ sơ sinh.
Anak rai (dt)	Con rồng.
Anal (dt)	Con sâu nái.
Anal kŏ (dt)	Cái gối.
Anăn 	I.(dt) tên. Anăn kâo nam: tên tôi là nam.
                                  	Ii.(đại từ chỉ định) đó
Anăn kdrưh (dt)	Danh hiệu.
Anăp (giơïi từ)	Trước. Ti anăp: Phía trước. 
Anei (đt)	Đây. Anei [yøng kâo: đây là bạn tôi. Kâo mă bruă ti anei: tôi làm việc ở đây. 
Aneh (dt)	Deã.
Angĭn (dt)	Gió. Angyøn dưr: Gió băc. Angyøn đru\ng: Gió lốc
Angĭn êbŭ (dt)	Bão.
Angưr (đgt)	Ngẩng. Angưr ko\: Ngẩng đầu.
Anghar (đgt)	Ngáy. Pyøt anghar [rok [rok: Ngủ ngáy khò khò.
Anôk (dt)	Nơi
Anôk dôk (dt)	Nơi ở
Anôk dôk êjai (dt)	Nơi tạm truô.
Anôk mjưh (dt)	Nơi dừng. Anôk mjưh êdeh: Bến xe.
Anôk mjưh mran (dt)	Cảng.
Anuă (dt)	Cái cưa.
Anŭng (dt)	Tuôi. Anu\ng hăt: Tuôi thuốc lá.
Anur (dt)	Con duôi.
Anut (dt)	Cái cuôc áo. Sa boh anut: Một cái cuôc. 
Añŭ (dt)	Hạt cườm (chuỗi). Kngan buh ayûu\: Cổ tay đeo cườm.
Añuê (dt)	Chiếu. Lang ayûuê kơ adei pyøt: Trải chiếu cho em ngủ.
Añhuôr (đgt)	Duỗi. Ayûhuôr jơ\ng ]iăng đăm êgah: Duỗi chân cho đỡ mỏi.
Añhuih (đgt)	Hỉ. Ayûhuih êa adu\ng: Hỉ mũi.
Ao (dt)	Aoûo. Ao ko#: Aoûo trăng. Ao hjan: Aoûo mưa.
Ap (đgt)	Đè.
Ap gư̆ (đgt) 	Đàn áp.
Aprŏng (dt)	Bác (chị của mẹ).
Ară anei (trgt)	Hiện nay
Arăn (đgt)	Rặn. Arăn kkiêng: Rặn sinh.
Arăng (đt)	Người ta. Kâo hmư\ arăng blu\ lu kơ ayo\ng: Tôi nghe người ta nói nhiều về anh.
Areh (dt)	Con rệp. Areh ke\ ktăl êdi: Rệp căn ngứa thật.
Ariêng (dt)	Con cua.
Aruăt (dt)	Gân
Arul (dt)	Họ của người Êđê.
Arưp aram (đgt)	Đe dọa. Phung roh arưp aram mdjiê jih mnuih [uôn sang: bọn giặc đe dọa giết sạch dân làng.
Asăp (dt)	1. Lời. Asăp blu\: Lời nói.
	2. Khói. Asăp pui: Khói lửa.
Asăp mtrŭn (dt)	Nghị quyết
Asăr (dt)	1.hạt
	2. Viên. Asăr phao: Viên đạn.
Aseh (dt)	Con ngựa. Sang kâo mâo rông dua drei aseh ko#: Nhà tôi có nuôi hai con ngựa trăng.
Asâo (dt)	Con chó. Rông dua drei asâo: Nuôi hai con chó.
Asei (dt)	Thân
Asei mlei (dt)	Thân thể
Asei wah (dt)	Lưỡi câu.
Atăt (đgt)	Đón. Atăt ba kâo nao truh ti anôk ayo\ng mă bruă: Đón tôi đi đến nơi anh làm việc.
Atâo (dt)	Người chết (thi hài người chết).
Ai tiê (dt)	Tấm lòng.
Ai tiê jăk (dt)	Sự tốt bụng
Ai tiê kriăng (tt)	Chăm chỉ
Atŭt (dt)	Đốt. Atu\t kram: đốt tre; atu\t kđiêng kngan: đốt ngón tay. Atu\t klang ro\ng: đốt sống. 
Atiêng (dt)	Nhánh. Atiêng êya: Nhánh gừng.
Awa (dt)	Bác (anh trai và chị gái của bố). Awa Hồ: Bác Hồ. 
Awak (dt)	Cái theãa.
Awak boh (dt)	Cái muôi (làm băôûng tre).
Awan (dt)	Khuôc
Awăt (tt)	Yếu
Ayŏng (dt)	Anh. Ayo\ng adei: Anh em.
Ayŏng khua (dt)	Anh cả.
	 
A	 
Al (đgt)	Măng
Al čôñ (tt)	Giận hờn.
Am (đgt)	Nướng. Aûm ]yøm ]iăng bi ksă: Nướng thịt cho chín.
Ap (đgt)	1. Bịt. Aûp đyøng êa: Bịt ống nước. 
                                  	2. Aoûp. Aûp knga ti mtih: Aoûp tai vào vách.
	3. Chườm. Kdô pioh ăp: Tuôi chườm.
At (pht)	1. Vón. Kâo ăt dôk ti anôk hđăp: Tôi vón ở chỗ cũ.
	2. Cũng. Aáu ăt myøn mse\ si kâo mơh: Nó cũng nghĩ như tôi; Ih la] snăn
	 
B	 
Ba (đgt)	Mang. Djă ba: Mang theo. 
Ba tian (đgt)	Mang bầu (có chửa dùng cho người).
Ba kđi (đgt)	Bồi thường.
Bai (dt)	Giỏ. Bai djah: Giỏ rác.
Bai đih (dt)	Nôi (em beô).
Ban (đgt)	Trườn.
Bă (đgt)	Đụng
Băk (đgt)	Đeo (vào cổ). Băk klei mah: đeo dây chuyền vàng.
Bĕ (tht)	Thôi! (yô hối thuôc). Nao be\ : đi thôi!
Bê (dt)	Dê (con vật). Bê knô: Dê đực; Ana bê: Dê mẹ.
Bhang (dt)	Hè
Bhañ (đgt)	Hăt hơi.
Bhĭ (dt)	Tên của một lịi chim. }yøm bhyø: Chim phí.
Bhiăn (phoï từ)	Thường. Aáu bhiăn kgu\ êla: Nó thường dậy muộn.
Bhiâo (tt)	Một luôc
Bhiâo hin (pht)	Chóng vánh.
Bhiâo riâo rit	Chốc lát
Bhĭr (đgt)	Neôm.
Bhĭt (tt)	Rậm.
Bhĭt pum/bhĭt dliê (dt) 	Bụi rậm.
Bhôk gah (dt) 	Ngăn nhỏ ở gian trước nhà sàn Êđê. 
Bhŏng bhŏng (đgt)	Aòo ạt. K[iă bho\ng bho\ng mse\ si klap: Ra ào ạt như  mối.
Bhung aguah (trt)	Suốt đêm. Mlam bhung aguah hlo\ng amâo pyøt: Suốt đêm không ngủ.
Bhung bhang (tt)	Sáng sủa.
Bi	1. (lt) Còn. Kâo nao mă bruă bi anak kâo dê nao sang hră: Tôi đi làm còn con tôi đi học. 
	2. (trt) Phải. Bi nao mtam ]iăng kơ hmao: Phải đi ngay cho kịp.
Bi ăl (đgt)	Giận nhau.
Bi blŭ (đgt)	Đàm thoại
Bi čĭk (đgt)	Vật nhau.
Bi dơ̆k bi dria (tt)	Rộn rã. 
Bi êdah (đgt)	Thể hiện
Bi hlĭ (tt)	Hòa thuận. 
Bi hdơr (đgt)	Tưởng nhớ.
Bi kbưi (đgt)	Cách ly. 
Bi kjăp (đgt)	Củng cố. 
Bi kmiêk (đgt)	Eøm nhau
Bi lar (đgt)	Trau dồi. 
Bi leh (đgt)	Hịn thành. 
Bi liê (đgt)	Tiêu
Bi lir (gt)	Liền nhau (sát). 
Bi lông	1. Thi (thi cử). Bi lông klei Êđê: Thi tiếng Êđê.
	2. Đua. Bi lông êdeh: đua xe.  
Bi lui (đgt)	Ly dị
Bi mđĭ (đgt)	Nâng cao. Bi mđyø klei thâo săng: Nâng cao kiến thức.
Bi mĭn (đgt)	Suy nghĩ.  
Bi mlih (đgt)	Thay đổi.
Bi mtlaih (đgt)	Giải thít
Bi ruê̆ (đgt)	Kết thuôc
Bi rŭng (đgt)	Gây rối
Bi ŭk bi ăk (tt)	Tấp nập (chỉ sự ồn ào
Bi yông (tt)	Yoù lại nhau.  
Biêng (đgt)	Đập. }ăm biêng: đánh đập.
Biêr (tt)	1. Lùn. Jar mnuih biêr: Dáng người lùn. 
	2.Thấp. Ana kyâo biêr: Cây thấp.
Bih (dt)	Thuộc nhóm dân tộc Êđê.
Bip (dt)	Vịt. Bip knô: Vịt đực.
Bip êa (dt)	Con vịt nước.
Bir (dt)	Vỉa hè. Eùbat ti dlông bir êlan: đi (bộ) trên vỉa hè.
Biut (dt)	Mây.
Blač (đgt)	Mổ. Bla] prô] êbeh: Mổ ruột thừa.
Blah 	I.(đgt)1. Bổ. Blah djuh: bổ củi
          	2. Chẻ. Blah đrao: Chẻ nứa.
	Ii. Từ dùng để đếm số cái
Blang (đgt)	Nở (hoa). Mnga blang: Hoa nở.
Blao (tt)	Nhát. 
Bliư̆ 	I.(đgt). Lật.  Eùdeh bliư\: xe lật.
	Ii.(dt). Lần. Eùma bliư\
Blô (tt)	Bầu (bĩnh). {o# blô: Mặt bầu bĩnh.
Blŭ (đgt)	Nói. Blu\ êku\t: Nói sau lưng; Blu\ lo\k luăl:Nói ngọng; Blu\ mdiêr: Nói quanh co; Blu\ mgao: Nói quá; Blu\ mha]:
Blŭ bi hmư̆ (đgt)	Nói khóe.
Blŭ mhriêng (đgt)	Nói bóng.
Blŭ tlao (đgt)	Cười nói.
Blŭ wah wơ (đgt)	Nói trống không.
Blŭ myâo (đgt)	Nói kheôo. 
Blŭ yăl (đgt)	Nói năng. 
Boh 	I.(dt) 1. Quả
	2. Trứng. Boh mnu\: Trứng gà.
	Ii.(đgt) giặt. Boh ]hum ao: giặt quần áo.
	Iii. Từ dùng để đếm cái. Dua boh k]ok (]hiên): hai cái ly (cheôn). Sa boh sang: một ngôi nhà. Năm boh ]ar: sáu tỉnh. Eùma boh êyûan: năm bậc thang.
Boh anăn (dt)	Danh từ.
Boh anut (dt)	Cái khuy (cuôc áo). Kă boh anut ao: đơm cuôc áo.
Boh areh (dt)	Long não.
Boh bip êđai (dt)	Trứng vịt lộn.
Boh dlông (dt)	Chiều cao
Boh đê̆č (dt)	Hoa văn. Myûam boh đe#]: Dệt hoa văn.
Boh blŭ (dt)	Từ ngữ (từ vựng).
Boh blŭ mčuê (dt)	Giới từ
Boh ƀai (dt)	Diện tích.
Boh ƀleh (dt)	Thận
Boh hră (dt)	Chữ
Boh kbưi (dt)	Cách xa
Boh jhat (tt)	Sự xấu xa.
Boh jing (dt)	1. Tính từ.
	2. Thành quả.
Boh kê̆ñ (dt)	Bánh chè.
Boh kŏ (dt)	Cái đầu. Ruă kno\ng sa boh ko\: đau mỗi cái đầu.
Boh kpăt (dt)	Bồ hòn. Phyø mse\ syø boh kpăt : đăng như quả bồ hòn.
Boh lăn (dt)	Trái đất. Boh lăn dar: Trái đất quay.
Boh m’ô̆(dt)	1. Hầu (người)
	2. Xịi rừng (hột nhỏ).
Boh mdê (dt)	Đặc thù.
Boh mtuh (dt)	Lựu đạn.
Boh nik (nak) (tt)	Nhất là. 
Boh păm (dt)	Bồ kết. }ô ko\ ho\ng êa boh păm: Gội đầu băôûng nước bồ kết.
Boh pha (dt)	Băp vế.
Boh phŭn (dt)	Nội dung. 
Boh pia (dt)	Phụ âm.
Boh tih (dt)	Băp chân.
Boh tluôn (dt)	Cái mông.
Bŏ (tt)	Đầy. 
Bŏk (đgt)	Sưng
Bŏk yơi (dt)	Quai bị.
Bŏk wi wu (đgt)	Sưng vù. 
Bŏng bŭ (dt)	Beãm bịp.
Bông (dt)	Quan tài (hòm).
Bơ bhô (tt)	Eøuïng ộc.
Braih (dt)	Gạo. Ple#] braih: Vo gạo.
Braih ka hroh (dt)	Gạo lức.
Braih mkuê̆ (dt)	Gạo (gạo thóc nói chung). Sang kâo amâo mâo braih mkue# ôh: Nhà tôi không có gạo thóc geã cả.  
Brang (dt)	Gai (cây gai).
Brei (đgt)	Cho. 
Bring (tt)	Rỉ
Brô̆(dt)	Đàn. Pe\ bro#: đánh đàn (ghi ta).
Bru bra (đgt)	Tán loạn.
Brŭ (tt)	Thối. {âo bru\: Hôi thối. 
Brŭ hiă (tt)	Thối hoăc
Bruă (dt)	Việc.
Bruă čuăn (dt)	Quy định
Bruă kmrơ̆ng dhông (dt) 	 
Bruă lŏ hma (dt)	Nông nghiệp
Bruă lĭng kahan (dt)	Quân sự.
Bruă mă (dt)	Nghề nghiệp. 
Bruă mă hgăm (dt)	Công tác bí mật.
Bruă mă kơ lu mnuih (dt) 	 
Bruă mdrao mgŭn (dt)  	1. Y tế. Knơ\ng bruă mdrao mgu\n: Trung tâm y tế. 
	2. Y khoa. Sang hră gưl pro\ng hriăm bruă mdrao mgu\n:   Trường đại học y khoa.
Bruă mgang ala čar (dt) 	Quốc phòng.
Bruă mjeh mjuk (dt)	Công tác dân vận.
Bruă tĭng yap (dt)	Kế tín.
Bruă truh (dt)	Sự việc.
Bruă yua (dt)	Công dụng.
Bruă yua kiê kngan (dt)	Nghề thủ công.
Brung (tt)	Đốm. Miêu brung: mèo đốm.
Brung brê̆č (tt)	Sặc sỡ. H’ô ao brung bre#]: Mặc áo sặc sỡ.
Buê (dt)	Hoa tai (bông tai). }u\t buê mah: đeo bông tai vàng.
Buh (đgt)	1. Đeo ( ở tay
	2. Trỉa. Buh mdiê: Trỉa luôa.
Buk 	I. (tt) phồng.
	Ii. (dt) nệm. 
Bum (tt)	Mù
Bŭr (đt)	Hạch. Bo\k buôr: Sưng hạch.
Bur (dt)	Cháo. {ơ\ng bur: aûn cháo.
Bŭ (dt)	Con gái (gọi thân trong nhà). Eû bu\
Bŭč (đgt)	Nhổ. Bu\] rơ\k mdiê: Nhổ cỏ luôa.
Bŭl (tt)	Cuộn (dây
Bŭng (dt)	Cái gùi. Bu\ng điêt: Gùi nhỏ.
Bư̆ (đgt)	Rào. Bư\ mnư\: Rào hàng rào.
Bư̆ guê (đgt)	Đăp bờ.
Bưn (dt)	Vườn (ở xa nhà
Bưng (dt)	Bát (làm băôûng bầu khô). 
Bưng gŏ (dt) 	Nồi niêu.
	 
Ƀ	 
Ƀah (tt)	Mẻ (sứt). }hiên [ah: Cheôn bị mẻ.
Ƀah dah...ƀah dah	Vừa...vừa. Ayo\ng kâo [ah dah ]iăng nao hma [ah dah ]iăng đru ama ngă sang: Anh tôi vừa muốn đi róy vừa muốn giuôp bố tôi làm nhà.
Ƀai 	I.(tt) rộng.  {ăng bhă anei [ai: cái cửa này rộng. 
                    	Ii.(đgt) aoûc ôn. Phung jhat [ai: bọn ác ôn.
Ƀai kdai (tt)	Rộng rãi.
Ƀaih (ct)	Eøi (chỉ sự ngạc nhiên).
Ƀaih haih (ct)	Aoûi chà.
Ƀal (đgt)	Đẽo.
Ƀă (đgt)	Địu
Ƀă anak lung êra	Chửa con so.
Ƀă pum (dt)	Chửa hoang.
Ƀăl (tt)	Chát.
Ƀăng (dt)	1. Lỗ. {ăng adu\ng: Lỗ mũi.
	2. Hốc. {ăng êro\ng kyâo: Hốc cây
	3. Hầm. {ăng ê-ưng: Cái hầm.
	4. Hang (động). {ăng ariêng: Hang cua. {ăng boh tâo: Hang đá. 
Ƀăng bhă (dt)	Cái cửa (dùng chung).
Ƀăng bhă điêt (dt)	Cửa sổ.
Ƀăng bhă prŏng (dt)	Cửa ra vào.
Ƀăng đuê̆ dăp (dt)	Hầm hào.
Ƀăng eh (dt)	Hậu môn.
Ƀăng êa (dt)	Giếng nước. 
Ƀăng êgei (dt)	Miệng (mồm).
Ƀăng jang (dt)	Cổng
Ƀâo (tt)	Hôi. 
Ƀâo brŭ (tt)	Hôi thối.
Ƀâo iu (tt)	Eøi thiu ( Bị ôi
Ƀâo khơr (tt)	Khai ( mùi khai)
Ƀâo kmĭl (tt)	Hôi nách.
Ƀâo mnâo (đgt)	Đánh hơi.
Ƀâo mngưi (tt)	Thơm (mùi thơm). Mnga [âo ngưi: Hoa thơm.
Ƀap (dt)	Cái ví. {ap dưm prăk: Cái ví bỏ tiền; {ap djă ti kngan; Ví xách tay.
Ƀar (đgt)	Mặc (váy
Ƀar h’ô (đgt)	Aûn mặc.
Ƀĕ (dt)	1. Cái. Tlâo [e\ giê: Ba cái que. 
	2. Cây. Dua [e\ giê ]ih: Hai cây viết; Năm [e\ ana [ơr: Sáu cây bơ.
Ƀê̆č (đgt)	Bóy. {e#] [ưi: đặt bóy; {e#] kkuih: Bóy chuột.
Ƀê̆č ƀê̆č 	Lẩm bẩm. 
Ƀê̆ñ (dt)	Bánh. {e#YÛ [ao: Bánh bao; {e#YÛ boh hra: Bánh rán; {e#YÛ trang: Bánh tráng. 
Ƀê̆ñ hra (dt)	Đường ăn.
Ƀê̆ñ kpŭng (mi) (dt)	Bánh meã.
Ƀê̆ñ mlim (dt)	Kẹo. Pluh klo\ mlim: Mười viên kẹo.
Ƀhĭ (tt)	Nát
Ƀhĭ ƀhê̆ñ (tt)	Li ti.
Ƀhiăr (tt)	Phẳng leã. 
Ƀhơi (đgt)	Đáng.
Ƀhu (đgt)	Phơi.
Ƀhư (tt)	Rộ. Mdiê ksă [hư: Luôa chín rộ.
Ƀhŭl (dt)	Bụi mù.
Ƀhur (tt)	Thổi. {hur pui: Thổi lửa.
Ƀi (yu)	Bi. Boh [i: Viên bi.
Ƀiă (tt)	Æt.
Ƀiă dhit	Quá ít.
Ƀiă ƀiă (tt)	Chuôt ít.
Ƀiă dah (lt)	Nhưng.
Ƀiêk (dt)	Khóe miệng
Ƀiêp ƀiêp (tt)	Nhai nhải. Blu\ [iêp [iêp: Nói nhai nhải.
Ƀiêr (dt)	Bia. Mnăm [iêr: Uống bia.
Ƀik ƀik (tt)	Nườm nượp. Mmông mă bruă êdeh êrô [ik [ik bo\ êlan bi kduê: Giờ cao điểm xe nườm nượp nối đuôi nhau.
Ƀĭng (dt)	Bạn. 
Ƀĭng găp (dt)	Bạn bè. 
Ƀĭng khăp (dt)	Người yêu.
Ƀĭng kna (dt)	Đồng chí.
Ƀlă (dt)	Ốc sên.
Ƀlĕ (đgt)	1. Chảy. Eùa [le\: Nước chảy. 
	2. Mọc. Yang hruê [le\: Mặt trời mọc. 
	3. Trổ. Mdiê mrâo [le\: Luôa mới trổ bông.
Ƀlĕ eh (đgt)	Ía. Hđeh điêt [le\ eh hlăm ]hum: đứa beô ỉa trong quần.
Ƀlĕ êa ală (đgt)	Rơi nước măt.
Ƀlĕ k’hŏ k’hang (đgt)	Tít mồ hôi.
Ƀlĕ tlao (đgt)	Pheã cười (bật cười).
Ƀlĕ k’ul (tt)	{Uồn nôn.
Ƀlê̆č ƀlir (tt)	Đểu. Eùđai [le#] [lir: đồ đểu.
Ƀlia (tt)	Láng. {u\k gyø [lia: Tóc chảy láng bóng.
Ƀling (tt)	Leô. Ală [ling: Măt leô.
Ƀlĭp ƀlĭp (tt)	Chớp (ánh sáng). 
Ƀlir (đgt)	1. Dán. {lir rup: Dán heãnh (ảnh). 
Ƀlir ƀlir (tt)	Long lanh. 
Ƀlĭt (tt)	Dính.  {ơ\ng đio\ [lyøt kngan: aûn xôi dính tay.
Ƀloh (dt)	Muỗi.
Ƀlŏng ƀlŏng (tt)	Veôo von.
Ƀlŏng ƀlut (tt)	Lênh đênh.
Ƀlô (dt)	Một nhánh người thuộc dân tộc Êđê.
Ƀlông (dt)	Gòn. Ana [lông: Cây gòn.
Ƀluôn (dt)	Muôi. {luôn boh kneh: Muôi mít.
Ƀlŭng (dt)	Hố.
Ƀô (đgt)	Mê . {ô mniê êra siam: Mê cô gái đẹp.
Ƀôñ (tt)	Bện. {ôyû klei: Bện dây.
Ƀô̆(tt)	Mặt. {o# wyøl: Mặt tròn; Tuôm [o# so# ală: Găp nhau tay băt mặt mừng. 
Ƀô̆mta (dt)	Khuôn mặt (mặt mày). 
Ƀơ̆ng	I. (đgt) 1. Aûn (ăn trái cây
	2. Cháy. Pui [ơ\ng sang: Cháy nhà.
	Ii. (tt) 2. Săc (beôn). Dho\ng [ơ\ng: dao săc (beôn).
Ƀơ̆ng dôč (tt)	Aûn vặt.
Ƀơ̆ng hŏng kngan	Aûn bốc.
Ƀơ̆ng ngăn (tt)	Aûn hối lộ
Ƀrĭk (dt)	Gạch. Klo\ [ryøk: Viên gạch.
Ƀrah ƀrơp (tt)	Long đong.  
Ƀrô mơh	May ra.
Ƀrôč (tt)	1. Thủng. Go\ [rô]: Nồi bị thủng. 
	2. Dột. Sang [rô]: Nhà bị dột.
Ƀruêh (dt) (Anh)	Bàn chải. {ruêh ]hao êgei: Bàn chải đánh răng.
Ƀrôk ƀrôk (tt)	Oang oang. 
Ƀrŏng (dt)	Ngọn (cây).
Ƀru ƀra (tt)	Tán loạn.
Ƀruih (dt)	Bụi. 
Ƀruih ƀram (dt)	Bụi bặm.
Ƀrŭk ƀrŭk (tt)	Sùng sục. Eùa ktơ\ng [ru\k [ru\k: Nước sôi sùng sục.
Ƀrư̆ ƀrư̆ (tt)	Dần dần
Brư̆ hruê ƀrư̆(lt)	Càng ngày càng. 
Ƀuah (đgt) 	Trách. 
Ƀuăn (đgt)	Hứa. Klei [uăn: Lời hứa.
Ƀuăn rơ̆ng (đgt)	Cam đoan
Ƀuh (đgt)	Thấy. Ală [uh
Ƀuh klei soh	Thấy khuyết điểm.
Ƀun (dt)	Nghèo.
Ƀun ƀin (dt)	Nghèo nàn.
Ƀuôn (dt)	1.buôn
                                	2. Aõaúp. Ryøng mnuih [uôn sang jing [uôn: Chiêu dân lập ấp.
Ƀuôn hgŭm (dt)	Phường
Ƀuôn phŭn (dt)	Thủ đô.
Ƀuôn prŏng (dt)	Thành phố
Ƀuôn sang (dt)	Làng mạc
Ƀuôr (đgt)	Khơi (mương). {uôr êa nao hlăm lo\: Khơi nước vào ruộng.
Ƀur (dt)	Bụi cây nhỏ (lùm cây ). {ur kpal: Bụi rậm.
Ƀŭk (dt)	Tóc. GYØ [u\k: Chải tóc. {u\k k]ar: Tóc sâu
Ƀŭk ƀiêk (dt)	Tóc tai. 
Ƀŭl ƀŭl (tt)	Đông đuôc.
Ƀư̆ (đgt)	Eõỡn (người)
	 
Č	 
	 
Čah (dt)	Vấp. Tăm ]ah boh tâo: Vấp phải đá.
Čai (dt)	Nhựa cây dầu
Čaih (đgt)	Bừa. }aih lo\: Bừa ruộng. 
Čam (dt)	Chăm. Phung Chăm: Người chăm.
Čan (đgt)	Vay. }an prăk: Vay tiền. 
Čang (đgt)	1. Mong
	2. Viếng
Čang hmang (đgt)	Trông mong. 
Čao (đgt)	Khóet.
Čar 	I. (dt). Tỉnh  }ar dak lak: tỉnh dak lak.
	Ii. (đgt) chẻ. }ar mnu\ng: chẻ lạt.  
Čar adhei (dt)	Vầng trán.
Čar kwar (dt)	Tổ quốc.
Čar tač êngao (dt)	Nước ngịi
Čă (dt)	Hà. }ă [ơ\ng jơ\ng: Hà ăn chân.
Čăm (đgt)	Đánh. }ăm biêng:  đánh đập (hành hung). 
Čăm ƀlê 	Làm thuốc cho cá say.
Čăp	I. (đgt).trói
	Ii. (dt). Bó. Blei dua ]ăp djam bei: mua hai bó rau cải. 
Čăt (đgt)	Mọc. Ktơr ]ăt dlông leh: Ngô đã mọc cao. }ăt êgei: Mọc răng. 
Čăt bĭn (tt)	Chai sần. Plă kngan ]ăt byøn: Bàn tay chai sần.
Čăt oh 	Mốc. Braih ]ăt oh leh: Gạo đã lên mốc.
Čeh (dt)	Cheô (cái cheô). Dua boh ]eh kpiê: Hai cheô rượu.
Čĕ (dt)	Chăt (cháu bốn đời). Aduôn kâo mâo dua ]ô ]e\: Bà tôi có hai đứa chăt.
Čê (dt)	Chè (trà). Mnăm êa ]ê: Uống nước chè (trà).
Čê̆č (đgt)	Giăôûm. }e#] amre#]: Giăôûm ớt.
Čê̆č kdrê̆č (tt)	Tỉ mỉ.
Čhai (đgt)	Bàn ( bàn bạc
Čhao (đgt)	Đánh.}Hao êgei: đánh răng. }hao druôm jơ\ng: đánh giày.
Char (dt)	Thanh la
Chăt (đgt)	Thái (thịt). }hăt ]yøm u\n: Thái thịt heo.   
Chiăm (dt)	Khăn. }hiăm sut: Khăn lau. }hiăm siap jhưng:  Khăn trải bàn. }hiăm gue#]: Khăn trùm. }hiăm băk hrah: Khăn quàng đỏ.
Chiăm gru lăn ala	Lá cờ Tổ quốc.
Chiăm hnun (dt)	Tã lót. Păn ]hiăm hnun kơ anak: Quấn tã lót cho con.
Chiên (dt)	Cheôn. }hiên êsei: Cheôn cơm.  
Chiên mngan (dt)	Cheôn bát.
Chĭ (đgt)	Bán.
Chĭ mnia (đgt)	Buôn bán.  
Chĭ kơ ala tač êngao	Xuất khẩu.
Chŏ (tt)	Bẩn.  
Chŏ mrŏ (tt)	Bẩn thỉu. Jơ\ng kngan ]ho\ mro\: Chân tay bẩu thỉu.
Chŏ djhan (tt)	Dơ bẩn.
Chông (dt)	Vũng nước bẩn.
Chŏng mran (dt)	Đò. Waih ]ho\ng mran: chèo đò.
Čhuang (đgt)	Bước. }huang êbat: Bước đi.
Čhum (dt)	Quần. }hum ao: Quần áo; }hum dlông: Quần dài;}hum đu\t: Quần đùi (quần ngăn).
Čhŭ, čhuai (đgt)	Nhầm
Čhŭñ (đgt)	Nếm. }hu\YÛ [iă kpiê; Nếm chuôt rượu.
Čhưn (đgt)	Chơi. Dôk ]hưn: Ngồi chơi; Nao ]hưn: đi chơi; 
Čhưn ênguê đt)	Tham quan
Čhưn dhing (dt)	Du lịch  
Čiă (đgt)	Gọt (quả)
Čiăng (đgt)	Muốn. 
Čiêm (đgt)	Cho ăn. }iêm u\n: Cho lợn ăn.
Čiêm adei huă	Đuôt cho em ăn.
Čiêm rông (đgt)	Nuôi dạy.
Čiêng (đgt)	Đeo (cặp
Čih(đgt)	Ghi
Čih knăl (dt)	Ghi chuô.  
Čih hră êa drao	Kê đơn thuốc.
Čih rup (đgt)	Họa
Čih mđaŏ (dt)	Chính tả.
Čih mkra (đgt)	Biên soạn. }ih mkra hdruôm hră mblang klei Êđê- Yuăn: Biên soạn sách từ điển Êđê-Việt.
Čĭk (đgt)	Vật. Bi ]yøk: Vật lộn.
Čĭm (dt)	1. Thịt. }yøm ghang: Thịt nướng băôûng vĩ;  }yøm ăm: Thịt nướng; }yøm krô (thu): Thịt khô; }yøm mtah: Thịt tươi (sống); }yøm đeh: Thịt chiên(sào); }yøm ksâo: Thịt dọi; }yøm aruăt:Thịt bạc nhạc. }yøm prayø: Thịt mỡ.
	2. Chim. }yøm ]ap: Chim chóc; }yøm hrai: Chim sẻ; }yøm iăt:  Chim eôn; }yøm jhưng: Con cò; }yøm jông: Con yểng; }yøm kôk: Chim cuốc; }yøm wăt: Chim cuôt; }yøm bhyø: Chim phí; }yøm wyøt ]ô: Chim khách; }yøm [ơ\ng kan: Chim bói cá; }yøm ktyøa: Con vẹt.
Cĭm pun (dt)	Con cheo.
Cing (dt)	Chiêng. Tông ]ing: đánh chiêng.
Čing čhar (dt)	Cồng chiêng.
Čiu (đgt)	Đền. Brei ]iu: băt đền. 
Čĭng čă (dt)	Thăôûn lăôûn.
Čoh (đgt)	1. Mổ. Mnu\ ]oh mkue#: Gà ăn tấm. 
	2. Căn. Ala ]oh jơ\ng êmô: Răn căn chân bò.
	3. Cuốc. }oh lăn: Cuốc đất.
Čoh čuăn	Cơ bản.  
Čoh boh (tt)	Cộc lốc.  
Čŏng (dt)	Đỉnh
Čŏng thơ̆ng (dt)	Tự nguyện.  
Čŏng mâo (dt)	Tự nhiên.  
Čô	1.(dt) Cháu (ông bà gọi). Aduôn [ă ]ô: Bà cõng cháu.
	2. (đgt) Gội. Kâo ]ô ko\: Tôi gội đầu.
	3. ( từ dùng đếm số người: đứa
Cô đơ điêt, čô ƀia ƀiă	Mỗi người một ít .
Côñ (đgt)	Tự ái.  
Cua (đgt)	Vạch đường để chọc lỗ tỉa luôa.
Cuă 	1. (dt) Bã (rượu).  Suai ]uă kpiê ]eh: đổ bã ruợu cần.
	2. (đgt) Thăm. Kâo nao ]uă aduôn kâo: Tôi đi thăm bà tôi.
Cuă mđing (đgt)	Thăm dò.  
Cuă awăng (đgt)	Tuần tra.  
Cuah (dt)	Cát. Lăn ]uah êga: đất cát sỏi. Kdăn ]uah: Bãi cát.
Cuăn (dt)	Qui định.
Cuăn dar (đgt)	Vây kín
Cuê (đt)	Lối mòn (con thuô đi tạo ra)
Cuê nuê	Nối nòi ( tục nối dây trong luật hôn nhân của người Êđê xưa).
Cuh (đgt)	Đốt
Čuh ul (tt)	Buồn nôn.
Čuk (đgt)	1. Uoùi. Eùdeh ]uk lăn: Xe ủi đất.
	2. Dũi. Uyõn êđai ]uk amung hlăm tian ana duah ksâo: Lợn con dũi mõm vào bụng mẹ teãm vuô.
Čung (đgt)	Deãu. }ung êbat: Deãu đi.   
Čung ba (đgt)	Deãu dăt. 
Čuôn k’ŭt (đgt)	Quyoå gối. 
Čuôr (dt)	1. Mái. }uôr sang: Mái nhà.
  	2. Bãi (vùng có nhiều khe suối tiếp nối nhau). }uôr dăng: Khe suôi nối tiếp nhau; }uôr rơ\k: Bãi cỏ ven sông.
Čuôr hip mdơ̆ng	Nóc tủ.
Čuôt (tt)	Bủn xỉn.  
Čuôt knhit (tt)	Hẹp hòi.  
Čur (đgt)	Vót. 
Čut (dt)	Đậu mùa (bệnh).  
Čŭm (đgt)	Hôn
Čŭm hrip (đgt)	Hôn hít.
Čŭr (dt)	Vôi. }u\r [ơ\ng êhăng: Vôi ăn trầu.}U\r mia sang: Vôi queôt nhà. 
Cŭr čih (dt)	Phấn viết. 
Čŭt (đgt)	1. Căm. }u\t wah:  Căm câu; }u\t đyøng kpiê: Căm cần rượu.
	2. Đeo. }u\t buê: đeo bông tai; }u\t krah: đeo nhón.
	3. Mặc (chỉ dùng cho mặc quần) }u\t ]hum: Mặc quần. 
Čŭt mnơ̆ng	Măc mồi câu.
Čư̆ (dt)	Nuôi.
Čư̆ čhiăng (dt)	Nuôi non.  
Čư̆ drông (dt)	Dãy nuôi.
Čư̆ kbuôn tring ahing	Nuôi non trùng điệp.
Čưng (đgt)	Đá.  
Čưng boh (đgt)	Đá bóng.  
Čưng mlâo mnŭ (đgt)	Đá cầu.
	 
	 
D	 
Dai wĭt dai nao (đgt)	Đu đưa.
Dai kngan (đgt)	Đưa tay. Eùbat dai kngan: đi đưa tay. Dai êjao: đưa võng. 
Dam (dt)	Con trai (từ dùng gọi con trai). Eû dam: Con trai ơi.
Dam knai (dt)	Bạn bè trai.   
Dan (đgt)	Aûn xin. Mnuih hiu dan: người đi ăn xin.
Dang (dt)	Đĩa (hát). Dang đyøng mmuyû: đĩa hát
Dar 	I. (đgt) quay. Eùru\m mmông adôk dar: kim đồng hồ còn quay.  
	Ii.(dt) vòng. Sa dar: một vòng.  
Dat (đgt)	Đập (đập đồ vật). Dat k]ok ti dlông jhưng: đập ly trên bàn.
Dap (tt)	Băôûng (băôûng phẳng). Anôk dap: Nơi băôûng phẳng.
Dăng (đgt)	1. Giăng. Dăng yûuăl mă kan: Giăng lưới băt cá.
	2. Chăng (dây). Dăng klei [hu ]hum ao: Chăng dây phơi quần áo. 
Dăng rĕ (dt)	Lá giang.
Dăp (đgt)	Xếp. Dăp dua prue#: Xếp hai hàng. Dăp ]hum ao dưm hlăm hip: Xếp quần áo bỏ vào trong tủ; Dăp pioh mhing: Xếp thành đống. Dăp bi prue#: Xếp theo hàng lối; Dăp rơ riêm: Xếp thứ tự; Dăp bi kpă: Xếp cho thẳng.  
Dăp êmiêt (tt)	Săp xếp. Dăp êmiêt mnơ\ng mnuă hlăm pưk sang khuăt mluăt: Săp xếp đồ đạc trong nhà cho gọn gàng.
Dăp boh pia	Gieo vần.
Dê̆č (đgt)	Trốn (tránh). De#] bruă: Trốn việc; De#] đue# hiu: Trốn đi chơi.  
Dê̆č dar (tt)	Tráo trở.
Dhar kreh (dt)	Văn hĩa.  
Dhiăr (dt)	Chong chóng.
Dhit dhut (tt)	Lề mề.  
Dhŏng (dt)	Dao. Dho\ng riêk m’ar: Dùng dao rọc giấy; Dho\ng khăt: Dao căt; Dho\ng klo\k: Dao găm; Dho\ng ku\p: Dao bầu; Dho\ng kuêh: Dao cạo; Dho\ng krah: Dao cầu; Dho\ng [ơ\ng êhăng: Dao cheãa vôi (ăn trầu); Dho\ng gut: Dao nhíp; Dho\ng k]oh ]yøm: Dao pha; Dho\ng tlo\ êrah: Dao phay; Dho\ng k’kut: Dao xếp.
Dhua (tt)	Liên lụy. Đăm ngă bi dhua truh kơ mnuih mkăn: đừng làm liên lụy đến người khác.
Dhuan (tt) 	Phiền hà
Dhul (dt)	Sương mù. Aguah ưm yan hjan khăng mâo dhul: Sáng sớm mùa mưa thường có sương mù.
Dhŭng (dt)	Nam (miền
Dhut bưng (dt)	Số phận.   
Dhut hdĭp (dt)	1. Số kiếp. Dhut hdyøp [rah [rơp: Số kiếp long đong.
	2. Vận mệnh. Sa djuê ana leh dưi ngă phu\n kơ dhut hdyøp pô: Một dân tộc đã làm vận mệnh của meãnh.
Dhŭp (đgt)	Thụp. Dôk gu\ thu\p ti gu\: Ngồi thụp xuống.
Di ñu, di gơ̆ (đt)	Họ (ngôi thứ ba số ít).
Diăn (dt)	Cây nến. }uh pui diăn: Thăp nến.
Diăn kra (dt)	Ngọc lan. Pe\ mnga diăn kra: Hái hoa ngọc lan.
Dĭng buăl (dt)	Đầy tớ. Dyøng buăl đru bruă kơ mnuih [uôn sang: đầy tớ cho nhân dân.
Djah  (dt)	Rác. Kih djah: Queôt rác.  
Djah djâo  (dt)	Rác rưởi.
Djah djap (tt)	Lôi thôi. Mă bruă djah djap: Làm việc lôi thôi.
Djaih (dt)	Nhựa cây để bóy chim.
Djam (dt)	1. Rau. Djam bei: rau cải; Djam brang: Rau đay; Djam [âo mngưi: Rau thơm; Djam [âo anghir: Rau diếp cá; Djam mlăng: Rau mồng tơi
	2. Canh. Tu\k djam tro\ng: Nấu canh cà.
Djam tam (dt)	Rau (nói chung).
Djam bei boh (dt)	Củ cải.
Djam bei đŭng (dt)	Băp cải (băp suô).
Djam bei hla êrui	Cải xanh.
Djam đrê̆č (dt)	Bèo. Djam đre#] hlăm êa ênao: Bèo trong ao.
Djam bei mnoh hgơr (dt)	Su hào.
Djao (dt)	1. Xơ. Djao êyăn: Xơ mướp. 
	2. Vợt. Tuah kan ho\ng djao: Vớt cá băôûng cái vợt.
Djao wak wai	Màng nhện.
Djă (đgt)	1. Cầm. Djă giê ]ih: Cầm buôt viết. 
	2. Giữ. Djă êdeh waih kơ kâo pom: Giữ xe đạp cho tôi bơm. 
Djă kŏ (đgt)	Đón đầu.
Djă krơ̆ng (đgt)	Đảm nhiệm. 
Djăl (tt)	Mau
Djăl hin (tt)	Mau chóng
Djăl ƀiă (tt)	Nhanh lên
Djăp (tt)	1. Đủ. Mă bruă kno\ng djăp [ơ\ng huă: Làm việc chỉ đủ ăn. 
	2. Các. Eùnu\m djăp mta giê ]ih: đủ các loại buôt.
	3. Mọi
Djiê (đgt)	Chết
Djiê brŭ (tt)	Chết chóc.
Djiê hdĭp (đgt)	Sống chết. Djiê hdyøp mbyøt hrăm: Sống chết có nhau.
Djiê mdriêng (đgt)	Chết tai nạn.
Djiêt (đgt)	Văt.  Djiêt krue# ]êyû: Văt chanh; Djiêt ]hum ao bi thu êa: Văt quần áo cho ráo nước.
Djiêu (tt)	Cạnh. Ti djiêu: Bên cạnh.
Djim (đgt)	Bâu. Ruê djim: Ruồi bâu.
Djiu (đgt)	Rù. Mnu\ djiu: Gà rù.
Djeh djut (tt)	1. Kèo nhèo. Mo# yûu khăng djeh djut êdi: Vợ nó hay kèo nhèo lăm. 
	2. Lặt vặt. Blei du\m mnơ\ng djeh djut: Mua mấy thứ lặt vặt. 
	3. Nhỏ nhen. Mniê anăn snăk: Cô ấy rất nhỏ nhen.
Djĕ djuñ (tt)	Nhẹ nhàng.  
Djik djak (đgt)	Mỉa mai. Tlao djik djak: Cười mỉa mai.
Djĭk djơ̆k (tt)	Lầy lội. Eùlan klông djyøk djơ\k: đường sá lầy lội.
Djhĭt djhĭt (tt)	Sụt sịt. Hia djhyøt djhyøt: Khóc sụt sịt. 
Djhĭt djhŭt (tt)	Dầm dề. }hum ao djhyøt djhu\t msă: Quần áo dầm dề ướt.
Djhông djhông (tt)	Ngân nga. Asăp wao hla djhông djhông: Tiếng sáo diều ngân nga.
Djŏ (tt)	1. Truông. Mnah djo\ anôk ]uăn: Băn truông mục tiêu; Djo\ angyøn: Truông gió. 
	2. Đuông. }ih djo\ boh blu\: Viết đuông từ.
Djŏ ai 	I. (đgt) đăc yô.  
	Ii. (tt) . Thích chí. Djo\ ai tlao bi ariăk: thích chí cười giòn giã.
Djŏ guôp	Thích hợp
Djŏ hnơ̆ng  	Điều hòa. Yan adiê djo\ hnơ\ng: thời tiết điều hòa.
Djŏ tuôm	Liên quan.  
Djŏk (tt)	Chín nhũn. Mtei ksă djo\k: Chuối chín nhũn.
Djuê (dt)	1. Lịi
	2. Họ. Mă djuê amyø: Lấy họ mẹ.
Djuê ana (dt)	Dân tộc.  Djuê ana [iă: Dân tộc thiểu số; Djuê ana lar: Dân tộc đa số. 
Djuê anăn (dt)	Họ tên.
Djuh (đt)	Củi.  
Djŭp (đgt)	Huôt. Dju\p hăt: Huôt thuốc.
Djhŭr djhăr (tt)	Nhầy nhụa.  
Dlai (tt)	Tràn. Eùa dlai: Nước tràn.
Dlăm (đgt)	Liệng
Dlăng (đgt)	1. Đọc. Dlăng hră: đọc sách.
	2. Coi
	3. Xem:  Dlăng rup: Xem tranh; Dlăng Tiwi:Xem ti vi.
Dlăng ba (đgt)	Chăm nom.   
Dlăng klei ruă (đgt)	Khám bệnh.
Dlăng pruê̆ bi kpă	Gióng hàng cho thẳng.
Dlao (đgt)	Chửi
Dlao wač kuač kčĭng (tng): Xè vaí, chưíi bơïi.	 
Dleh (tt)	Khó. Klei tyøng anei dleh: Pheôp tính này khó. 
Dleh knap (tt)	Gian khổ.  
Dleh dlan (tt)	Khó khăn
Dleh êmăn (tt)	Khó nhọc.  
Dliê (dt)	Rừng. Dliê kpal: Rừng dày; Dliê mkuôm: Rừng cấm; Dliê khua: Rừng già.
Dliê tlô (dt)	Phong cảnh.  
Dliu (tt)	Heôo. Djam dliu: Rau uôa.
Dlô (dt)	Não (óc).  
Dlô klang (dt)	Tủy. 
Dlông (tt)	1. Dài. Ao dlông kngan: Aoûo dài tay.
	2. Cao. Aáu dlông hyøn kơ kâo: Nó cao hơn tôi; Dlông awan dhuan: Dáng cao ráo.
Dlông ai (tt)	Nhón nại
Dluih (đgt)	Xoa bóp.  
Dlưh (đgt)	Sập. Dlưh [ăng ê- ưng: Sập hầm.
Dlưh ai (tt)	Cảm động. 
Dlưh trŭn (tt)	Suy sụp. 
Doh (tt)	Sạch.  
Doh bhung (tt)	Sạch sẽ.
Dŏ (dt)	Đồ. Do\ yua hriăm hră: đồ dùng học tập.
Dŏ dô (dt)	Đồ đạc.  
Dôk (đgt)	1. Đang. Kâo dôk mă bruă: Tôi đang làm việc.
	2. Lấy. Dôk mo##: Lấy vợ. Dôk ung: Lấy chồng.
Dôk anôk	Eûoù cư.oä 
Dôk asei lưng	Eûoù trần.
Dôk čhưn	Ngồi chơi.
Dôk dơ̆ng (đgt)	Đứng.
Dôk gŭ (đgt)	Ngồi xuống.
Dôk jhŏng jhư (đgt)	Ngồi xổm.
Dôk kjăp	Eøaén định.
Dôk kăp (đgt) 	Phục kích.
Dôk mang 	Eûoù không.
Dôk hliê (tt) 	Độc thân.
Dôk jŭm dar (đgt)	Ngồi xung quanh.
Dôk suôr (tt)	Găn bó.
Dôk ti	Eûoù tại
Dôk ti krah	Eûoù giữa.
Dŏng (tt)	Cứu.
Dŏng dăt (tt)	Nguông nguẩy.  
Dơ̆k dria (tt)	Nháo nhác. Eùran dơ\k dria hiu duah: Chạy nháo nhác đi teãm.
Dơ̆ng (đgt)	1. Săp. Aáu dơ\ng dôk ung: Nó săp lấy chồng; Dơ\ng truh tian: Chuyển dạ.
	2. Chững. Hđeh mrâo thâo dơ\ng: đứa beô mới biết chững. 
Dơ̆ng mơ̆ng	Từ. Dơ\ng mơ\ng sang kâo truh kơ sang ]ơ năng ai 5km: Từ nhà tôi đến chợ khoảng 5km.
Dơr (đgt)	Chôn (vùi). 
Dơr ƀăng (đgt)	Lấp hố.
Drai (dt)	Thác. Drai êa: Thác nước.
Drang (tt)	Phượng hịng.
Drao (dt)	Bùa
Dră (đgt)	Chống (đỡ). Dră pưk huyø le\ buh: Chống chòi để khỏi đỗ. 
Dră k’iêng (đgt)	Chống nạnh.  
Drei 	I. (đt) ta
	Ii. (dt). Con (từ dùng để đếm số lượng con vật). Dua drei ]yøm: hai con chim; tlâo drei êmô: ba con bò.
Dria dria (tt)	Rôm rả.  
Driah (tt)	Giát. Pơ\ng driah jhưng: đóng giát giường.
Drô̆(dt)	Rọ. Mă u\n bi mu\t hlăm dro#: Băt lợn cho vào rọ.
Drông (đgt)	Đón. Kâo nao drông anak: tôi đi đón con.
Druôm (đgt)	Chặt
Dua (sôú từ)	Hai. Dua pluh: Hai mươi (20); Dua tal: Hai tầng
Dua klei blŭ (dt)	Song ngữ. Drei bi yua dua klei blu\ syøt nao mtô la] hlăm [uôn sang djuê ana hriêt: Chuông ta phải dùng song ngữ khi vào tuyên truyền trong [uôn làng dân tộc thiểu số.
Duah (đgt)	Teãm
Duah ênŭč (đgt)	Gây sự. Duah ênu\] bi mneh msao: Gây  sự để chửi nhau. 
Duah đaŏ (tt)	Aoùo tưởng.
Duah hmư̆ (đgt)	Nghe ngóng.
Duah ksiêm dlăng (dt)	Khảo sát.
Duah ksiêm mkra (đgt)	Nghiên cứu. Duah ksiêm mkra klei ruă truh kơ u\n
Duah hưn (đgt)	Phao tin.
Duah mčeh (đgt)	Bịa đặt. 
Duah mhing (đgt)	Rêu rao. 
Duah mnê̆č (tt)	Mưu mô.
Duah mnê̆č jhat	Aõm mưu
Duam (tt)	Ốm (đau). Ruă duam: ốm đau. 
Duê (dt)	Thơ. Klei duê: Bài thơ. 
Duh bruă(đgt)	Giuôp việc.  
Duh mkra (đgt)	Tổ chức
Duñ (đgt)	Nhặt
Duñ duñ (đgt)	Lẩm bẩm
Duôm (đgt)	Vá. Duôm ]hum ao tyø: vá quần áo rách.
Dŭ (đgt)	Chuyển. Du\ braih ba kơ êdeh: Chuyển gạo ra xe.
Dŭč (đgt)	Đốt . Hông du\]: ong đốt; aguăt du\]: bò cạp đốt.
Dŭm (đt)	1. Mấy? Du\m thu\n? Mấy tuổi?. 
	2. Bao nhiêu? Du\m ]hyø sa ]ăp? Bao nhiêu một bó. 
Dŭm boh sui 	Bao lâu.
Dưi	1. Được. Hđeh năm thu\n dưi nao mu\t hriăm adu\ sa: Trẻ em sáu tuổi được vào học lớp một. 
	2. Đậu. Dưi bi lông mu\t gưl hriăm pro\ng: đậu vào đại học. 
	3. Thăng. }ưng boh dưi leh: đá bóng thăng rồi.
Dưm (đgt)	1.đặt. Rup awa hồ dưm ti dlông jhưng: tượng bác hồ đặt trên bàn. 
	2. Đựng. Giêt dưm kpiê: Chai đựng rượu; Go\ pro\ng dư\m braih: Nồi to đựng gạo.
Dưn (đgt)	Kế thừa
	 
D	 
Da (gt)	1. Với. Brei kâo đa: Cho tôi với. 
 	2. Cả. Đa ih mơh nao: Cả anh cũng đi. 
                                 	3. Nữa. Kâo đa:  Tôi  nữa.
Da đa (ht)	Vân vân. Mâo lu mta kan hdyøp hlăm êa mse\ si kan ko#
Dah	I. (dt). Hào. Sa prăk dua đah: một đồng hai hào.
	Ii.(dt) đánh. Bơ drei hlăp đah tuôr: nào chuông ta chơi đánh cù.
Dah da (dt)	Ngực. 
Dal (đgt)	1 Gối. Đal ko\: Gối đầu.
	2. Chèn. Đal pông êdeh: Chèn bánh xe. 
Dang (dt)	1 Luống. Đang djam bei: Luống rau cải.
	2. Vườn. Đang kphê đang ksu Dak Lak: Vườn cà phê vườn cao su Dak Lak. 
	3. Đảng. Đảng drei sa ai ho\ng [uôn sang: đảng ta một lòng veã dân.
Dao (dt)	Đao
Dao đao (tt)	Aõm ấm. Eùa anei đao đao: nước này âm ấm.
Daŏ (đgt)	1. Tin. Kâo đao\  ih la] syøt: Tôi tin anh nói thật. 
	2. Đín. Kno\ng đao\ mtrưm: Chỉ đín mò.
Dar (đgt)	Gõ. Đar ko\: Gõ đầu.
Dat (tt)	Tẹt. Adu\ng đat: Mũi tẹt.
Dă (tt)	Cong. Giê anei đă: Cây này cong.
Dăk (đgt)	Bẻ. Đăk ktơr: Bẻ băp (ngô).
Dăm (bt)	1. Đừng
	2. Ngủ lại. Ih đăm ho\ng hmei: Anh ngủ lại với chuông tôi. 
	3. Chớ. Đăm ngă snăn: Chớ làm như vậy.
Dăng (tt)	Giòn. Eùtak [hu đăng măng ai: đậu phơi giòn quá cỡ.
Deh (đgt)	1. Xào (xào các loại thực phẩm). Đeh ]yøm êmô: Xào thịt bò. 
	2. Chiên. Đeh boh bip: Chiên trứng. 
	3. Rang (rang các loại hạt
Đei (tt)	Quá. Hayû đei: Quá mức.
Đê (dt)	1. Trục. Đê pông êdeh: Trục bánh xe.
	2. Xà ngang dưới sàn nhà dài Êđê.
Đê̆č (đgt)	Làm hoa văn. Arăng đe#] siam snăk: Người ta làm hoa văn rất đẹp.
Đhăn (đgt)            	Quấy. Hđeh điêt hlơr đhăn hia jih sa mlam: Beô ấm đầu quấy khóc suốt đêm.
Đhih đhuaih (tt)	Eõỡn ẹo. Aáu êbat đhih đhuaih: chị đi ưỡn ẹo.
Đhiăk đhiăr 	I.(đgt) ve vẩy. Asâo đhiăk đhiăr ku: chó ve vẩy đuôi.
	Ii.(tt) rông. Eùran hiu đhiăk đhiăr kluôm [uôn: chạy rông khăp xóm.
Đhĭt đhĭt/đơ đhĭt (đgt)	Phất phới. }hiăm gru pưh đhyøt đhyøt: Lá cờ bay phất phới.
Đhuk đhuk (tt)  	Khoan thai. Awan dhuan đhuk đhuk: Dáng dấp khoan thai.
Đi (dt)	Điếm (đĩ).
Đi čơ (tt)	Đĩ điếm. 
Đi đư (tt)	Đong đưa. Aáu gui bu\ng êbat đi đư: nó bước đi cái gùi đong đưa.
Đih (đgt)	Năôûm. Đih đang: Năôûm ngửa; đih ku\p: Năôûm uôp; đih ]iêng: Năôûm nghiêng; đih ku\n năôûm co;  đih sang êa drao: Năôûm viện.
Đih pui (dt)	Eûoù cữ. Truh mlan đih pui: đến tháng ở cữ.
Đing (đgt)	Nghi. Aáu đing amâo djo\: Anh nghi không đuông.
Đing đaŏ (đgt)	Nghi ngờ. 
Đing đang (tt)	Ngả nghiêng. 
Đing đưng (tt)	Bồng bềnh. 
Điâo (dt)	Trái. Tyøng điâo: Bên trái.
Điêt (tt)	1. Nhỏ. Adei điêt: Em beô. 
	2. Beô. Boh mnu\ điêt: Quả trứng gà beô.
Điêt kriêt (tt)	Nhỏ xíu
Điêt dhiêt (tt)	1.Beô nhỏ. Eùđai mnu\ điêt dhiêt: Gà con beô nhỏ.
	2. Chuôt xíu. {iă điêt dhiêt kâo soh: Chuôt xíu nữa tôi sai.
Điŏ (dt)	Nếp. Braih đio\: Gạo nếp; đio\ ê-un [ơ\ng jăk: Xôi dẻo ăn ngon.
Đĭ (đgt)	1. Cưỡi. Kâo đyø  êman: Tôi cưỡi voi. 
	2. Leo. Kâo đyø  kyâo: Tôi leo cây. 
	3. Lên. Kâo đyø sang: Tôi lên nhà.
	4. Đi. Kâo đyø mran: Tôi đi thuyền.
Đĭ ai (đgt)	Động lực.
Đĭ ai krê̆ñ  	Nổi cơn giận
Đĭ ai kơ bruă	Hăng làm việc.
Đĭ ƀiă	Khá hơn. 
Đĭ kyar (bt)	Tiến bộ.
Đĭ đơ̆ (tt)	Chập chững. EYÕ hriăm êbat đyø đơ\: Beô tập đi chập chững.
Đĭng (dt)	Ống. Đyøng êa: ống nước.
Đĭng buôt (dt)	Sáo. I-u\ đyøng buôt: Thổi sáo.
Đĭng jô (dt)	Cuôp. Gru\p [ơ\ng ]ưng boh mâo mă đyøng jô: đội thăng đá banh được thưởng cuôp.
Đĭng khen (dt)	Kèn amônica.
Đĭng kpiê (dt)	Cần rượu.
Đĭng năm (dt)	Kèn bầu sáu ống.
Đĭng nuh (dt)	Ống tra luôa (ống đựng thóc để trỉa luôa trên róy).
Đĭng tiông (dt)	Ống tên.
Dĭng tŭt (dt)	Kèn ống nứa.
Doh (đgt)	1. Chảy. Eùa đoh: Nước chảy. 
	2. Keôo. Eùman đoh kyâo: Voi keôo gỗ.
Dŏ đơñ (tt)	Kệch cỡm. Blu\ yăl đo\ đơyû: aûn nói kệch cỡm.
Dŏk (dt)	Giọng. Đo\k amyø ê-un êdu: Giọng mẹ dịu dàng.
Dŏng đăt (tt)	Đỏng đảnh. Amai anei m’ai đo\ng đăt: chị này ưa đỏng đảnh.
Dŏng đưt (tt)	1. Bấp bênh. Mdhă kyøt đo\ng đưt: Ván kê bấp bênh. 
	2. Gập ghềnh. Eùlan lu boh tâo đo\ng đưt: đường nhiều đá gập ghềnh.
Đŏng dlơt (tt)	Thọt. Jơ\ng đo\ng dlơt: Chân thọt.
Đôk (đgt)	Bóc. Đôk hmôk kyâo: Bóc vỏ cây.
Đơ (trt)	1. Tất cả. Đơ mta mâo jing mbyøt: Tất cả của chung. 
	2. Cỡ. Đơ leh?: Cỡ bao nhiêu?.
	3 Những. Đơ gru đưm đă lă êlâo: Những di tích ngày xưa để lại.
Đơ đip (tt)	Trùng trùng điệp điệp. }ư\ ]hiăng đơ đip: Nuôi non trùng trùng điệp điệp.
Đơ đĭk (tt)	Ngăc. Djiê đơ đyøk: Chết ngăc.
Đơ đhiar (đgt)	Giãy nảy.
Đơ đhiăk (đgt)	Giãy dụa.
Đơ găt (tt)	To.
Đơ găt đơ gĭn (tt)	1. Vĩ đại. Sa bruă ngă đơ găt đơ gyøn: Một công treãnh vĩ đại. 
	2. Rộng lớn. Eùa ênao anei đơ găt đơ gyøn: Hồ này rộng lớn.
Đơl/đơt (tt)	Ngăn.
Đơl đhơl/ đơt dhơt (tt)	Ngăn ngủn.
Đram (đgt)	Đốt (đốt róy). Đram hma ênah: đốt róy mới.
Đrao (dt)	Nứa.đrao đyø jing siam mda: Nứa đang lên xanh tốt.
Đrê̆ñ (tt)	Giòn. {êyû trang leh uih ho\ng pui đre#YÛ: Bánh tráng nướng xong giòn.
Đrê̆ñ rơ riăp (tt)	Đanh. Eùnai boh phao đuh đre#yû rơ riăp: tiếng suông nổ đanh.
Đrê̆ñ rơ rŏk (tt)	Giòn tan (thức ăn).
Đring đring (tt)	Aõuïm ầm.
Đrŏng đrôč (tt)	Ốm nhòm.
Đrông (dt)	1. Dãy. Sang đrông: Dãy nhà.
	2. Băng (vải). Khăt sa đrông mnal: Căt một băng vải.
	3. Hịi. Ih ngă djo\ nanao đrông: Anh làm đuông hịi.
Đru (đgt)	Giuôp.
Đrut (đgt)	Nhuông. Đrut ]hiăm hlăm êa: Nhuông khăn trong nước.
Đrư̆ (dt)	Vó. 
Đuč (đgt)	Thôi. Kno\ng sa hruê đu]: Chỉ một ngày thôi.
Đung 	I. (đgt).1. Trôi. Eùa đung sa hlâo yep: nước trôi đôi deôp. 
	2 Bay. Hla krô đung hiu: Lá khô bay đi. 
	Ii. (dt) thóp. Đung hđeh điêt mgei êdah: thóp trẻ con đập thấy rõ.
Đup (tt)	Nhịn. Thâo đup djăp mta klei: Biết nhịn tất cả mọi việc.
Đup gưt (tt)	Lễ pheôp.
Đua (đgt)	1. Đội. Đua mu: đội mũ. 
	2. Mang. Đua ê-i: Mang thuông.
Đuê̆ (đgt)	1. Cuôt. Ih đue# yơh!: Anh cuôt đi. 
	2. Đi. Hmei đue#  dôk ti hma: Chuông tôi đi ở róy. 
	3. Bạt đi. Mdê mnuih đue# mdê anôk: Mỗi người bạt đi một nơi.
Đuê̆ dăp (đgt)	Aõaén nấp.  
Đui (đgt)	Giao hợp.
Đuôm (đgt)	1. Măc. Ao đuôm ti dhan kyâo: Aoûo măc trên cành cây. 
	2. Dính. Eùa prayø kdah đuôm  hlăm ao: Dầu băn dính vào áo.
	3. Cố định. Pơ\ng đuôm sa [yøt: đóng cố định một nơi.
Đuôn (dt)	Mũ
Đuôn jŏng (dt)	Nón lá.
Đuôn ê-i (dt)	Nón quai thao.
Đŭ (đgt)	Phạt.
Đŭng (đgt)	1. Gói. Đu\ng đio\ ho\ng hla mtei: Gói xôi băôûng lá chuối. 
	2. Đốp. Eùnai mtuh hmư\ đu\ng: Tiếng nổ nghe đốp.
Đŭt (tt)	1. Ngăn. Giê đu\t: Cây ngăn. 
	2. Thấp. Eùkei anăn đu\t: Anh đó thấp.
Dut dhŭt (tt)	Ngăn ngủn. 
Dưl (đgt)	Bẩy. Đưl  kmeh sang: Bẩy cột nhà.
Dưm (tt)	1. Xưa. Đưm mphu\n dô: đời xưa. 
	2. Cổ. Do\ dô đưm: đồ cổ.
	3. Đưm Ară: Xưa nay; đưm adih: Xưa kia.
	 
E	 
E- ĕ (tt)	Be beô.
Eh (dt)	Phân. Eh êmô: Phân bò.
Eh ală (dt)	Ghèn măt.  
Eh êgei (dt)	Cao răng.
Eh hluăt (dt)	Tơ tăôûm.
Eh klê (dt)	Phân xu. EYÕ mrâo kkiêng mâo eh klê: Trẻ sơ sinh có phân xu.
Eh mđiă (dt)	Rôm sẩy
Eh tlŏng (dt)	Ráy tai.  
Ek ek (tt)	Eng eôc. Uyõn ur ek ek: Lợn kêu eng eôc.
Ek ôk (tt)	Eøuïm ộp. Ajyøk myûê ek ôk: eùaúch kêu ồm ộp.
Ep (đgt)	Rèn. Ep hriăm: Rèn học; Ep mjuăt: Rèn luyện.
Et ot (đgt)	1. Ooøng ẻo. Eùbat et ot: đi õng ẻo.
	2. Cọt kẹt. Kram myûê et ot: Tre kêu cọt kẹt.
	 
Ĕ	 
Ĕ (tt)	Beô. 
Ĕk ŏk  (tt)	Nuôc ních. {o# mta e\k o\k: Bộ mặt nuôc ních.
Ĕr (dt)	Nốt nhạc. Aáu mmuyû amâo djo\ e\r: Anh hát không đuông nốt.
 	 
E	 
Ea (dt)	1. Nước. Eùa êngeh [hang: Nước trong văt. 
	2. Màu. Ao anei êa mtah: Aoûo này màu xanh.
Ea bah (dt)	Nước miếng.
Ea drao (dt)	Thuốc. 
Ea drao gŭn (dt)	Thuốc men.
Ea jua (dt)	Nước nôi.  
Ea juôr (dt)	Sông ngòi.  
Ea k’hŏ (dt)	Mồ hôi.
Ea klôñ (dt)	Nước hoa.
Ea ksâo (dt)	Sữa.
Ea pơ̆ng (dt)	Nước máy.
Ea pui (dt)	Dầu lửa.
Ea săng (dt)	Xăng.
E- ăt (tt)	1. Lạnh. Adiê hruê anei ê- ăt: Trời hôm nay lạnh; Djo\ ê- ăt: Nhiễm lạnh.
	2. Nguội. Eùsei ê- ăt: Cơm nguội. 
E- ăt hriêt (tt)	1. Lạnh ngăt. Kiê kngan ê- ăt hriêt: Bàn tay lạnh ngăt. 
	2. Lạnh lẽo. Yan puih ê- ăt hriêt: Mùa đông lạnh lẽo. 
	3. Lạnh giá. Dhul k’uă ê- ăt hriêt: Sương muối lạnh giá.
Eba (dt)	Cơm rượu.
Ebah (tt)	Kiệt. Eùbah ai tiê: Kiệt sức.
Ebai (dt)	Đậu ván.
Ebai grăm (dt)	Đậu ngự 
Ebai gri (dt)	Đậu rồng.
Eban (dt)	Họ eùban.
Ebat (đgt)	Đi.
Ebăng (tt)	Thính. Knga aê êbăng êdi: Tai ông rất thính.
Ebâo (dt)	Ngheãn. Sa êbâo: Một ngheãn.
Ebeh (tt)	1. Dư. Mâo êbeh sa êtuh ]ô mnuih: Có dư trăm người. 
	2. Nhiều/ trội. Mâo êbeh hyøn kơ kâo: Có nhiều hơn tôi; Ih mâo mdiê êbeh êgao kơ thu\n adih: Anh có luôa trội hơn năm trước.
Ebeh êbiêr (tt)	1. Dư dật. Prăk ngăn êbeh êbiêr: Tiền của dư dật. 
	2. Quá mức. La] snăn êbeh êbiêr đei: Nói thế thật quá mức.
	3. Dư thừa. Braih mdiê êbeh êbiêr: Thóc gạo dư thừa.
Ebhơr, êbơr (tt)	1.Trơn. Eùlan anei êbhơr: đường này trơn.
	2. Láng. Mnal anei êbhơr [lia: Vải này láng bóng.
Ebuê (đgt)	Từ trần.
Ebua (dt)	Môn. Eùbua anei ktăl: Môn này ngứa. 
Ebuh (đgt)	Ngã.
Ebhui (tt)	1. Rữa. Boh ksă êbhui: Quả chín rữa. 
	2. Mục. }yøm bru\ êbhui jih: Thịt thối mục hết.
	3. Bở. Mnal sô êbhui: Vải cũ bở ra. 
Ebŭ (dt)	Bão. Angyøn êbu\: Gió bão.
Ebŭng (dt)	Măng. 
Eƀak (tt)	1. Bừa bãi. Blu\ tlao ê[ak: aûn nói bừa bãi. 
	2. Tục. Dlao wa] ê[ak: Chửi tục.
Eƀăt (tt)	1. Gọn gàng.   
	2. Sạch. Mnuih ê[ăt: Người sạch.
Ečăm (dt)	Họ eù]ăm. ( họ của người Êđê).
Eda (dt)	Xà ngang.
Êdam (dt)	Thanh niên (nam). Hđeh êdam êra: Thanh niên.
Êdam ngiêk (dt)	Thiếu niên.
Êdah (tt)	1.lộ
	2. Hiện rõ. Aáu êdah klă êdi: Nó hiện rõ.
Êdah brưl (bt)	Rõ ràng.
Êdai (dt)	1.Bễ. Kwă êdai iu\ pui: Keôo bễ thổi lò. 
	2. Đưa. Eùdai jao: đưa võng. 
Êdak (dt)	Bí đao
Êdap (dt)	Vông. 
Êdeh (dt)	Xe.
Êdeh êdâo (dt)	Xe cộ.
Êdei (bt)	1. Sau. Aáu êbat êdei: Nó đi sau. 
	2. Kế. Mo# êdei: Vợ kế.
Êdei êdă (trt)	Sau cùng.
Êdei adih (trt)	Sau này.
Êdei anăp (trt)	Tương lai.
Êdê (dt)	Luồng.
Êdi (pht)	1. Rất
	2. Chăc. Eùdi he\? Chăc hả (thật không?).
	3. Thật vậy. Snăn êdi: Thật vậy; Djo\ êdi: đuông vậy.
Êdjin (tt)	Nhão
Êdu (tt)	1. Yếu. Mta bruă ăt dôk êdu: Phong trào còn yếu. 
	2. Dịu. Eùdu đo\k k[ông: Dịu giọng. 
	3. Keôm. Ală êdu: Măt keôm. 
Êdu čhut (tt)	Hời hợt.
Êdu êdŏk (tt)	Yếu keôm. Klei myøn êdu êdo\k: Suy nghĩ yếu keôm.
Êdŭk (dt)	1. Ngọn. Eùdu\k plei: Ngọn bí. 
	2. Sau cùng. Kpiê êa êdu\k kba: Rượu sau cùng nhạt. 
	3. Mũi. Eùdu\k đao: Mũi đao.
Êđai (dt)	1. Khốn/thăôûng. Eùđai ktu\t: Tên khốn. Eùđai asâo: Chó con.  
	2. Con (chỉ dùng cho con vật thay thực vật cây con). Eùđai êmô: Con bê; eùđai mdiê: Mạ.
Êđai pĭ (dt)	Thăôûng nhãi.
Êđal (dt)	Nông
Êđal blă (tt)	Đơn giản. 
Êđăp (tt)	Mát.
Êđăp drưm (tt)	Mát mẻ.
Êđê (dt)	Dân tộc Êđê.
Êga (dt)	Sỏi.
Êgah (tt)	Mỏi.
Êgah êgăn (tt)	Eù ẩm.
Êgap (tt)	Thợ săn.
Êgar (tt)	Lạ. Mnuih êgar: Người lạ.
Êgaih (tt)	1. Rõ ràng. Boh blu\ êgaih: Lời nói rõ ràng.
	2. Chính nghĩa. Drei mblah kyua klei êgaih mnga]: Chuông ta chiến đấu veã chính nghĩa.
Êgao (đgt)	Qua. Kâo êgao mnư\: Tôi qua hàng rào; eùgao sa thu\n: Qua một năm.
Êgei (dt)	Răng. 
Êhai (tt)	Rộng.
Êghaih (đgt)	Gỡ. Eùghaih nư: Gỡ nợ.
Êhao (tt)	1. Tốn. Huă [ơ\ng êhao: aûn uống tốn. 
	2. Thuận tiện. Hruê anei mă bruă êhao snăk: Hôm nay làm việc rất thuận tiện.
Êghăng (tt)	Chăc
Êhăng (dt)	Trầu.
Êhăk êhai (tt)	1. Lạc quan. Hdyøp m’ak m’ưr êhăk êhai: Sống vui vẻ lạc quan. 
	2. Hồn nhiên. Ai tiê êhăk êhai: Tấm lòng hồn nhiên.
Êhiô̆(tt)	Vãn. Sang ]ơ êhio# mnuih: Chợ đã vãn người.
Êhŭng (dt)	Dạ dày.
Êhưl (dt)	Lợi( lợi răng) 
Êhưng tt)	Rỗng.
Êhưng êhang (tt)	Trống rỗng.
Ê-i (dt)	Rổ
Ê-i rưng (dt)	Rá. 
Ê- i knguôr (dt)	Thuông mủng.
Ê- ih (tt)	1. Nhừ. Riă ]yøm tơl ê- ih: Hầm thịt đến nhừ.
	2. Chín mùi. Mtei ksă ê- ih: Chuối chín mùi.
Ê-iăt (tt)	Văng
Ê-iăt êyăng (tt)	Văng vẻ
Ê- iŏ (tt)	Yên lặng.
Ê- iô̆êyăng (tt)	Văng lặng
Êjai (trt)	1. Vừa. Hmei êbat êjai yăl dliê êjai: Chuông tôi vừa đi vừa nói chuyện. 
	2. Trong khi. Eùjai hmei dôk hriăm ih blu\: Trong khi chuông tôi đang học anh nói chuyện. 
	3. Trong luôc.  
Êjai anei (trt)	Hiện tại.
Êjai anei hin (trt)	Hiện giờ.
Êjai kơ tluôn (trt)	Quá khứ.
Êjao (dt)	Võng.
Êjăng (tt)	Chăc.
Êjung (dt)	Cây măt mèo. 
Êka (đgt)	Bị thương. 
Êkă (tt)	Nhám.
Êkăl (tt)	Đục. Eùkăl plu\k: đục ngầu.
Êkei (dt)	Nam (người).  
Êkei hruê (dt)	Nam giới
Êkŏ (đgt)	Đông/đặc. Eùa êko\ jing klo\ êa ê-ăt: nước đông thành đá; eùa [êyû êko\ tlit: nước đường đặc sệt.
Êkŭt (tt)	Văng.
Êklai (dt)	Tyoã.
Êklăk (dt)	Triệu.
Êla (tt)	Muộn
Êlah (dt)	Lưỡi.
Êlah pui (dt)	Ngọn lửa.
Êlah êa (dt)	Mặt nước.
Êlam (tt)	Sâu. {ăng êa êlam: Giếng nước sâu.
Êlan (dt)	Con đường. 
Êlan klông (dt)	Đường sá.
Êlan tâo (dt)	Ngôi (ngôi tóc). Tlak êlan tâo: Rẽ ngôi tóc.
Êlâo (gt)	Trước. Ih nao êlâo kâo dôk êdei: Anh đi trước tôi đi sau.
Êlhuê (tt)	Rộng.
Êlhuê êlhiăk (tt)	Rộng rãi.
Êlưih (tt)	1. Rẻ. Djam mtam êlưih snăk: Rau rất rẻ.
	2. Dễ. Klei tyøng anei êlưih: Pheôp tính này dễ hiểu.
Êlưih pưih (tt)	Rẻ mạt. 
Êlŏk (tt) 	Phiền
Êlơ̆k/ êñơ̆k (đgt)	Nhăc. Eùlơ\k wyøt êlơ\k nao sa klei anăn: Nhăc đi nhăc lại một chuyện đó.
Êma (dt)	Số 5. 
Êman (dt)	Voi.
Êmă (dt)	Mỡ.
Êmăn (tt)	Mệt. 
Êmăn êmiêt (tt)	Mệt mỏi. 
Êmăt (đgt)	Thiện xạ. 
Êmeh (dt)	Tê giác.
Êmit (tt)	Hiền.
Êmit êngiê (tt)	Hiền hậu.
Êmiêt (đgt)	Dọn.
Êmĭng (tt)	Lyoå.
Êmŏng (tt)	Mập.
Êmŏng êmă	Mập mạp.
Êmô (dt)	Con bò.
Êmông (dt)	Hổ. Eùmông bre#]: Báo; eùmông gu: Sư tử.
Êmuh (đgt)	Hỏi.
Êmut (đgt)	Gheôt. 
Êmưt (tt)	Chậm.
Êmưt dhưt (tt)	Chậm chạp.
Ênah (dt)	1. Mủ. Tiêng kbu\m ênah: Nhọt mưng mủ.
	2 . Róy mới.
Ênai đt)	Tiếng.
Ênai dhuai (dt)	Tiếng tăm. Amâo hmư\ ênai dhuai: Không nghe tiếng tăm geã.
Ênang (tt)	Hiền. Eùnang mse\ si hlô rang: Hiền như nai.
Ênang ê- ưt (tt)	Nhàn rỗi; chậm rãi.
Ênang ê- ưih, ênang blang (tt)	 
Ênao (dt)	Hồ.
Ênăng (dt)	Giun đất.
Ênăr (dt)	Sào. Sră giê ênăr: Lao cái sào.
Ênăp (tt)	Khăm.
Ênoh (dt)	1. Giá. Hruôm m’ar ênoh tlâo êbâo prăk: Quyển vở giá ba ngàn đồng. 
	2. Số lượng. Du\m ênoh mnuih dưi ngă?: Bao nhiêu số lượng người làm được?.
Ênô (tt)	Thật thà.
Ênông (đgt)	Gánh.
Ênua (dt)	Mạng người.
Ênuk (dt)	1. Thời. Eùnuk hđeh êlăk: Thời thơ ấu. 
 	2. Giai đoạn (thời kyoå).     
Ênuč (dt)	1. Nọc. Hnuê du] ho\ng ênu]: Ong đốt băôûng nọc.
	2. Đầu nhọt: eùnu] tiêng.
Ênŭm (tt)	Đủ.
Ênŭm ênap/ênŭm drŭm (tt)	 
Ênŭng (dt)	Lươn.
Êña (dt)	Quang. Eùyûa ênông: Quang gánh.
Êñah (đgt)	1. Vung. Eùyûah tloh klei kă: Vung đứt dây trói.
	2. Chao. Eùyûah ê-i djam: Chao rổ rau.
Êñan (dt)	Thang.
Êñăt (đgt)	Kyoå cọ. Eùyûăt bi doh: Kyoå cọ cho sạch.
Êñuei (dt)	Xâu
Êñuôl (dt)	Con tê tê
Êngăn (tt)	Eùm ả. Adiê êngăn: trời êm ả.
Êngăp (tt)	Ngập. Eùa êngăp bo\ dlai: Nước ngập tràn đầy.
Êngeh (tt)	Trong.
Êngeh ƀhang (tt)	Trong văt.
Êngiê (dt)	Hòa beãnh. Lăn êa leh êngiê: đất nước đã hòa beãnh.
Êngĭt (dt)	Trời.
Êngoh (dt)	Sốt.
Êngu (dt)	Vừng đen.
Êngŭm (tt)	Đông.
Ênguôt (tt)	Buồn.
Ênguôt ê-ưn (tt)	Buồn thiu.
Ênguôt dhuôt (tt)	Buồn bã. {o# mta ênguôt dhuôt: Vẻ mặt buồn bã.
Ênham (dt)	Đăùm. Uyõn ênham: heo đăôûm.
Ênham êrah (dt)	Vũng máu.
Ênhă (dt)	Diện tích. Eùnhă lo\: Diện tích thửa ruộng.
Ênhă ƀô̆(dt)	Bề mặt. Eùnhă [o# lăn: Bề mặt trái đất.
Ênhiang (dt)	Vùng
Êpa (tt)	Đói. Eùpa tian: đói bụng.
Epan (dt)	Con rít
Epei (đgt)	Mơ ( ngủ mơ).
Epih (tt)	Mỏng.
Epông (dt)	Thăn. Klo\ kđeh êpông: Miếng thăn nõn.
Epul (đgt)	Nhóm. 
Epul êya (dt)	Địn thể. 
Epŭk êpiăk (tt)       	Bơ phờ. 
Era (đgt)	Thiếu nữ. 
Erah (dt)	Máu.
Eran (đgt)	Chạy.
Eriâo (dt)	Lục lạc.
Erin (tt)	Nghèo.
Erin tap (tt)	Nghèo khổ.
Erĭt (tt)	Mồ côi.
Erĭt êrin (tt)	Côi cuôt.  
Eruê (dt)	Dấu
Eruê (dt)	Gai. Eùruê tlo\ jơ\ng: Gai đâm vào chân.
Eruh (tt)	Bê trễ.
Erŭm (dt)	Kim.
Esei (dt)	Cơm.
Esŭn (dt)	  Hành (củ hành). Eùsu\n hla: Hành lá; eùsu\n boh: Hành củ.
Esŭn atâo (dt)	Hẹ.
Esŭn ñô (dt)	Kiệu.
Esŭng (dt)	Cối.
Etak (dt)	Đậu.
Etak êbai (dt)	Chỉ chung các loại đậu. 
Etak aduôn sun (dt)	Đậu nành.
Etak čăt (dt)	Giá đỗ.
Etăng (đgt)	Xiết.
Etuh (dt)	Trăm.
E- un (tt)	1. Mềm. Ksueh ê- un 
	2. Dẻo. Eùsei ê- un: Cơm dẻo.
	3. Kheôo. Blu\ ê- un: Kheôo mồm.
E- un ê-ăk (tt)	1. Yếu ớt. Mnuih mă bruă ê- un ê-ăk: Người làm việc yếu ớt.
	2. Mềm nhũn. Jơ\ng kngan ê- un êăk: Chân tay mềm nhũn.
E- un dhun (tt)	1. Mềm mại. Plă kngan ê- un dhun: Bàn tay mềm mại. 
	2. Eùm dịu. Asăp blu\ ê- un dhun: Tiếng nói êm dịu.
E-un djun (tt)	Eùm ái.
E-ưp ê-ap (tt)	Aõaém thấp.
E-ưt (đgt)	Tạnh.
E-ưt hjan (tt)	Tạnh mưa.
Ewa (dt)	Hơi. Eùwa k’hul: Bốc hơi;  Tian mtuh mtưh êwa: Bụng đầy hơi.
Ewak (đgt)	Khuân. 
Ewang (tt)	Gầy.
Ewang êwĭt (tt)	Gầy gò. Asei mlei êwang êwyøt: Thân heãnh gầy gò.
Ewăng (đgt)	Lùng. Eùwăng duah phu\ng kne\: Lùng băt tên trộm.
Ewei (đgt)	Xe sợi. Eùwei mrai: Xe chỉ.
Eweh êwit (tt)	Khẳng khiu (người và động vật).  
Ewiên (dt)	Liệt (bệnh).
Ewiên êwu (tt)	Bại liệt.
Ewiêt (dt)	Kiệt (kiệt sức)
Ewư (đgt)	Mò. 
Ewư êpêč (đgt)	Mò móm.
Eya (dt)	Gừng.
Eyăn (dt)	Mướp.
Eyăng (tt)	Tĩnh mịch.
Eyông (dt)	Xà dọc trong nhà sàn Êđê.
Eyuh (đgt)	Lay. Eùyuh boh kroh: Lay rụng trái cây;
Eyuh kngan (đgt)	Băt tay nhau.
Eyui (dt)	Bóng. Eùyui kyâo. Bóng cây.
	 
Ê̆	 
	 
Ê̆č (dt)	Rau quế
Ê̆č dliê (dt)	Hương nhu
	 
G	 
	 
Ga (dt)	Khí đốt. Pui ga: Bếp ga
Gah (dt)                   	Nhà ngịi (phần phía trước của nhà dài Êđê dành cho khách và cho sinh hoạt lễ hội).
Gai (đgt)	Điều khiển. Si gai si gưt: bảo geã làm nấy.
Gai kpiê	Mời rượu (điều khiển tiệc rượu).
Gam (đgt)	Đậu
Gang (đgt)	Chặn
Găl 	I.(đgt) chặt. Găl adhan kyâo: chặt cành cây.
	Ii.(tt) có lyô. Hlei găl ? Ai có lyô ?
Găm (đgt)	1.Che. Aáu găm kđô kphê: Nó che bao cà phê.
	2. Đậy. Aáu găm go\ djam: Nó đậy nồi canh. Găm sir: đậy kín.
Găn (đgt)	Qua
Găn gao (đgt)	Qua lại.
Găp (dt)	1. Mái nhà. Găp sang anei ta\m ho\ng hlang: Mái nhà này lợp băôûng tranh.
	2. Bè bạn.
Găp djuê (dt)	Họ hàng.
Giăm (dt)	Gần
Giê (dt)	Que
Giê gai êdeh (dt)	Tay lái (xe ôtô).
Giêng (dt)	Công đoạn luồn sợi dọc vào go trong nghề dệt truyền thống.
Giê dra (dt)	Cây gậy.
Giê dưh (dt)	Đũa.
Giêt (dt)	Quả bầu
Giêu (dt)	Bóy thăt.
Gĭ (đgt)	Chải. Aáu gyø  ko\: Nó chải đầu.
Gĭr (đgt)	Cố. Di yûu gyør mă bi leh: Chuông nó cố làm cho xong.
Gĭr ktĭr (đgt)	Cố găng
Gĭr ktưn (đgt)	Phấn đấu.  
Gĭt gai (đgt)	Lãnh đạo. Y - Tu\ gyøt gai hmei jak êdi: Y - Tu\ lãnh đạo chuông tôi rất tốt.
Ghan (dt)	Buôn ( buôn bán).
Ghan mnia (dt)	Buôn bán. Aáu mă bruă ghan mnia: Nó làm nghề buôn bán.
Ghang (đgt)	Nướng. Kâo dôk ghang ]yøm u\n: Tôi đang nướng thịt lợn.
Ghă (đgt)	Can
Gŏ (dt)	Nồi
Gŏ ƀŭng (dt)	Nồi đồng. Amyø kâo mâo lu go\ [u\ng: Mẹ tôi có nhiều nồi đồng.
Gŏ êa čê (dt)	Aõaúm chè.
Gŏ êsei (dt)	1.(đen). Nồi cơm. Dai go\ êsei kơ kâo: đưa nồi cơm cho tôi.
	2.(bóng). Hộ gia đeãnh. Go\ êsei kâo mâo tlâo ]ô mnuih: Gia đeãnh tôi có ba người.
Gŏng (dt)	Cương.
Gŏng gô̆č (dt)	Bọ ngựa.
Gô (tt)	Cong.
Gô̆(đgt)	Hiếp dâm.
Gơ̆ (đại từ)	Nó (ngôi thứ ba số ít).
Gơ̆ng (dt)	Cột.
Grăn (dt)	Cán. Grăn wah: Cần câu. Mă grăn wah: Lấy cần câu.
Grat (dt)	Cấp bậc. 
Grăm (dt)	Sấm
Grăm kmlaĭ (dt)	Sấm seôt.
Grăp (phụ từ)	Mỗi. Grăp ]ô hmei nao hma s’ayø: Mỗi chuông tôi đều đi róy.
Grê 	Cái đòn cong.
Grê̆ñ (đgt)	Gầm. Eùmông gre#YÛ: Hổ gầm.
Gri 	I. (dt) cây
 	Ii. (tt) nhà săp đổ.
Griă (giơïi từ)	Sát. Gria\ lăn: Sát mặt đất.
Griăng (dt)	Nanh. Griăng asâo knur s’năk: Răng nanh của con chó rất nhọn.
Grĭ (dt)	1. Caöïu bẩn
	2. Đất (dơ bẩn trên cơ thể).
Grĭng (đgt)	Đỡ ( đỡ dậy)
Griŏ (dt)	Đường viền (rỗ rá)
Grĭp (dt)	Cái bóy chuột. Aáu nao [e#c\ gryøp:  Nó đi bóy chuột.
Groh (đgt) 	Sủa. Asâo groh: Chó sủa.
Grông (dt)	Hàng
Grôñ (tt) 	Thon buôp măng.
Gru (dt)	Dấu
Grua (dt)	Tua rua.
Gru bi kal (dt)	Chữ thập (+).
Gru jơ̆ngn (dt)	Dấu chân.
Gru kđiêng kngan (dt)	Dấu vân tay.
Gruê (dt)	1. Bàn chải.
	2. Lông bờm (trên lưng).
Gruê hlô ŭn	Lông lợn rừng.
Gruh (dt)	Vùng trũng
Grŭp 	I.(tt). Gục
 	Ii.(dt). Nhóm
Grư̆ (dt)	Con đại bàng.
Grưh (dt)	Xương sườn.
Gu (dt)	Cụp xuống
Gu ktơr (dt)	Cùi băp.
Guam (tt)	Ngượng
Guam ahuam (tt)	Ngượng ngùng.
Guê lŏ (dt)	Bờ ruộng.
Guê̆č (đgt)	Chịng. Kâo gue#]  ]hiăm: Tôi chịng khăn.
Gu ga (dt)	Quả thanh long.
Gu gê (dt)	Bọ dừa.
Guh (đgt)	Aoûnh lên
Guh k’ang (tt)	Lộng lóy
Gu tuk (dt)	Chim tu huô.
Gui (đgt)	Gùi (nước
Guôm (tt)	Bọc kín
Guôn (đgt)	Chờ
Gun (tt)	Vướng. Eùlan anei Gun ho\ng êdeh: đường này vướng xe.
Gung (dt)	Bóy sập.
Guôp (tt)	Hợp. Ao anei guôp  ho\ng ih: Aoûo này hợp với chị.
Guôr (dt)	Dọc (khoai nước
Guôp êlâo	Tiếp theo.
Gut (đgt) 	Uốn
Gưl (dt)	Bậc
	Cấp I.
Gưt asăp (dt)	Vâng lời.  Aáu gưt asăp amyø ama: Nó vâng lời cha mẹ. 
Gưr (dt)	Sự gia tăng.
Guôk (dt)	Guốc mang.
Guôl (dt)	Cây cọ.
Gŭt gu (tt)	Gật gù.
Gư̆ (đgt)	Aõaún
	 
H	 
	 
Ha (đgt)	Há. Ha [ăng êgei: Há miệng.
Hah (phụ từ)	Đây
Hal (đgt)	Xẻ. Hal ]yøm: Xẻ thịt.
Hak (đgt)	Dang. Hak jơ\ng: Dang chân.
Han (đgt)	Vá. Han pông êdeh: Vá xe.
Hang 	I.(dt).1.bờ. Hang êa krông: bờ sông.
	2. Bãi. Hang êa ksi\: Bãi biển.
	Ii.(tt). Rát. Hang kngan: rát tay.
Hao hao	Tiếng ồn trong đám đông.
H’ap (đgt)	Ngáp. Aáu h’ap ]iăng pyøt: Nó ngáp ngủ.
Har (đgt) 	Hấu (cầu kyoå).
Hat (tt) 	The.
Hă (phụ từ) 	1. Này
	2. Hả
Hăng (tt)	Cay. Mre#] Hăng: eûoût cay.
Hăt (dt)	Thuốc lá. 
Hăt klĭt (dt)	Thuốc xeã gà.
Hăt reh (dt)	Thuốc rê.
Hâo (đgt)	Báo
Hbâo (dt)	Tro. Kue# hbâo: Hốt tro.
Hbâo pruê (dt)	Phân bón.
Hbei (dt)	Khoai
Hbei ƀlang (dt)	Khoai meã.
Hbia (dt) 	Công chuôa
Hbiê (dt) 	Tên cây
Hbĭl (trạng từ)	Khi nào
Hƀlŏk (đgt)	Hối hận
Hƀơih (phụ từ) 	Ối chà
Hƀuê ktuê (đgt) 	Lần theo. 
Hƀuê ênuk (dt)	Lịch sử. 
Hda (dt) 	Chông loại nhỏ.
Hdang (dt)	Tôm. {ơ\ng hdang: aûn tôm.
Hdao (dt) 	Tên một loại cây
Hdăm (dt)	Con kiến. Hdăm ke\: Kiến căn.
Hdăng	I.(dt). Than. Ku\] pui hdăng: nhóm bếp than.
	Ii.(pt). 1. Đều. Hmei dua hdăng nao hma: hai chuông tôi đều đi róy.
	2. Lón. Hdăng pô: Lón nhau.
Hdei (đgt)	Sàng sẩy. 
Hdiêr (tt) 	Rống
Hdĭp (đgt)	Sống. Kâo hdyøp ti [uôn Alê B: Tôi sống ở buôn Alê B.
Hdjai (đgt) 	Chỉ động tác chuyển từ cành cây này sang cành cây khác của khỉ
Hdơr (đgt)	Nhớ. Ih hdơr mơ\ kâo?: Anh có nhớ tôi không?.
Hdơr knga	Nhớ ơn.
Hdrah (dt) 	1. Rừng non
	2. Đám rừng đã xí trước để làm róy.
	3. Ghềnh.
Hdrak (đgt)	Ho cảm
Hdrô (dt) 	Một giống luôa sớm Êđê.
Hdruôm (dt)	I.(dt) quyển. Brei kâo sa hdruôm klei êđê: cho tôi một quyển tiếng êđê.
	Ii.(đgt) bao
Hdruôm hră (dt)	Quyển sách.
Hdruôm jơ̆ng (dt)	Giày.
Hdruôm m’ar (dt)	Quyển vở.
Hđăp (dt)	Cũ
Hđeh, hđeh êlăk (dt)	Trẻ em
Hđeh êdam (dt)	Thanh niên (trai).
Hđeh ĭ (dt)	Trẻ sơ sinh.
Hđeh êra (dt) 	Thanh niên (gái).
Hđeh hriăm hră (dt)	Học sinh.
Hđĭ hđang (đgt)	Loay hoay
Hđô	Quên băôïng.
Hđô mla (dt)	Chỉ voi đực không có ngà.
Hđơ̆ng (tt)	Yên ổn.
Heh 	I. (dt) đơn vị đo chiều dài từ cùi chỏ đến ngón tay.
 	Ii. (đgt) hí (ngựa).
Hei (phụ từ)	Eõ
Hĕ (phụ từ) 	1. Đã (có yô khẳng định). Kâo mă he\ bruă: Tôi đã làm việc.
	2. Eõ
H’ê̆č hmưi (đgt) 	Cầu chuôc
Hê̆ñ (đgt)	Xấu hổ. Đăm he#YÛ  ôh: đừng xấu hổ.
Hgăl (tt)	Nguyên vẹn.
Hgăm (tt)	Kín
Hgao (đgt)	Bước ngang qua.
Hgơr (dt)	Cái trống.
Hgŭm ngă	Giuôp nhau.
Hia (đgt)	Khóc.
Hiă (tt)	Rữa. Bru\ hiă: Thối rữa.
Hiêk (đgt)	Xeô.
Hiên 	I.(tt) thóp. Hiên tian: thóp bụng.
	Ii.(dt) eo (quả bầu
Hik (đgt) 	Hệch. Hik tlao: Hệch miệng cười.
Hin (tt) 	Hiếm.
Hing (đgt) 	Đồn đại.
Hing ang (dt)	Danh tiếng
Hip (dt) 	Rương
Hip mdơ̆ng (dt) 	Tủ đứng.
Hip mgăn (dt)   	Tủ trà.
Hiu (đgt)	Đi rong
Hĭn (phụ từ)	Hơn.
Hĭn dĭn	Hơn hẳn.
Hjan (dt)	Mưa. Hjan le\ rah: Mưa rào.
Hjăn (tt)	Một meãnh.
Hjei (dt)	Dùi đục.
Hjŭng (dt)	Vợ lẻ. (vợ lẽ).
Hla (dt)	1. Lá. Hla luh: Lá rụng.
	2. Cái diều. Eùran hla: Thả diều.
Hlah (tt)	Ngán.
Hlai (tt)	Nguôi. Hlai ai: Nguôi giận.
Hlang (dt)	Cỏ tranh. 
Hlao	I.(dt) cái khay
	Ii.(đgt) khỏi bệnh
Hlăk 	I.(trạng từ) khi. Hlăk anăn: khi đó.
	Ii.(trợ từ) đang. Aáu hlăk lê#yû: nó đang chơi.
Hlăk hlai (tt)	Thỏa mãn.
Hlăm 	I. (giới từ) trong
	Ii. (tt). 1. Sỉ. }hyø hlăm: bán sỉ.
Hlăp (đgt)	Chơi. Hlăp ku\p dăp: Chơi trò trốn teãm.
Hlăp lê̆ñ (đgt)	Chơi đùa.
Hlăp mbŭl (đgt)	Nô đùa
Hlâo (dt)	1. Chày. Hlâo tăp mdiê: Chày giã thóc.
                                	2. Đôi. Sa hlâo jep: Một đôi deôp.
Hlâo êya (dt)	Chày nhỏ.
Hlei (đt)	1. Ai. Hlei nao ho\ng ih? Ai đi với anh (chị)?
	2. Geã (Từ dùng để khỏi tên) Hlei anăn ih? Anh (chị) tên geã?
Hli (đgt)	San phẳng.
Hli ai (đgt) 	Làm vừa lòng
Hliăng (dt)	Tên một cái cồng trong bộ cồng người Êđê.
Hlia (đgt)	Liếm.
Hliăr (tt)	Xảo quyệt.
Hliê (tt)	1. Lẻ loi
	2. Còn son
Hliêng (đgt)	Vác.
Hliêng wih (trgt)	Xế chiều.
Hin knap (dt)	Nghèo khổ. Sang kâo hin knap: Nhà tôi nghèo khổ.
Hiu êbat (đgt)	Tản bộ.  
H’iêng	I.(đgt) chiều chuộng.
	Ii.(tt) cưng
H’iêng h’ưi (tt)	Thương tiếc.
Hiu lua (đgt)	Đi săn.
Hiu lua mnah (đgt)	Săn băn.
Hiu puh hlô (đgt)	Đi đuổi thuô (mang tính chất bao vay).
Hĭp (hư từ)	Bức. Hlơr hyøp: Nóng bức.
H’ĭt (dt)	Yên tâm. H’yøt yơh ho\: Hãy yên tâm nheô.
Hgơr (dt)	Trống.
Hgŭm (đgt)	Địn kết.
Hgŭm ai (đt)	Phối hợp
Hjan ƀhŭk (dt)	Mưa phùn.
Hjan angĭn (dt) 	Mưa gió.
Hjiê (dt)	Kho (kho để thóc). Sang kâo mâo sa boh hjiê: Nhà tôi có một nhà kho.
Hla in jin (dt)	Lá bài.
Hla kơ (dt)	Lá cờ.
Hla kơ ala čar (dt)	Quốc kyoå.
Hla knih (dt)	Cây chổi.
Hlai (tt)	Nguôi. Hlai ai: Nguôi giận.
Hlăk anăn (trgt)	Bấy giờ
Hling (dt)	Gỗ mun.
Hlĭm (dt)	Mưa dầm. Adiê hlyøm: Trời mưa dầm.
Hlĭn (dt)	Sáp ong.
Hlĭng (dt)	Rót. Hlyøng êa: Rót nước.
Hlŏng (đgt) 	I.(dt) tên một cái cồng trong bộ cồng êđê.
	Ii.(phụ từ) 1.chí
	2. Luôn thể. Blu\t hriê hlo\ng hua\ yơh: Tiện thể đến đây hãy ăn cơm luôn thể.
Hlô (dt)	Thuô (con thuô). Di yûu mnah hlô: Chuông nó băn thuô.
Hlô mnơ̆ng (dt)	Thuô vật.
Hlông (đgt) 	Tạo ra
Hlua (đgt)	Dội
Hluăt (dt)	Con sâu.  
Hluê (tt)	1. Lỏng
	2. Theo
Hluh (tt)	Thủng.
Hmum (tt)	Lành (không rách). Hla hmum hlum hla tyø: Lá lành đùm lá rách.
Hlung (đgt)	Bợ
Hluôm (tt)	Nguyên hạt
Hlŭ (lŭ) (dt)	Bùn.
Hlŭl (tt)	Tăc
Hlŭn (dt)	Nô lệ
Hlŭt (đgt)	1. Dốc đầu xuống.
	2. Liều
Hlư̆ (đgt)	Đẩy ra.
Hma (dt)	Róy. Nao hma: đi róy.
Hmang (dt)	Cái khay đựng cheôn bát.
Hmăm (dt)	Chậu thau. 
Hmăng(đgt)	Ngóng
Hmăng hmưi (đgt)	Cầu mong
Hmăr (đgt)	Mau
Hmăt (đgt)	Quất
Hmei (đại từ)	Chuông tôi (ngôi thứ nhất số ít). Hmei dua: Hai chuông tôi.
Hmiêt mkăp	Săôïn sàng.
Hmlei (dt)	Bông xơ
Hmô (đgt)	Cho ví dụ
Hmôk (dt)	Vỏ cây.
Hmrot (tt)	Lẻ loi
Hmrui (dt)	Trầm bầu.
Hmưč (đgt)	Khấn hứa với thần.
Hmư̆ (đgt)	Nghe. 
Hmưi (đgt)	Cầu mong
Hna (dt)	Ná
Hnač (tt)	Dai.
Hnăl (dt)	Cái đệm.
Hnăn (đt)	Vậy. Hnăn lah: Vậy đó.
Hnăr (đt)	Trườn. EYÕ điêt thâo hnăr leh: Em beô biết trườn rồi.
Hnê̆č (đgt)	Tranh thủ.
Hngah (đgt)	Từ chối.
Hngam ram (tt)	Vị ngọt nhân nhấn đăng của rượu ngon.
Hngăn (dt)	Quả dâu đất.
Hngăp (tt)	Băôïng
Hngăp êyăng, hngăp hngơr	 
Hngŭt hngui (tt)	Sa sầm
Hngô (dt)	Cây thông. Đang hngô: đồi thông.
Hnĭng (đgt)	Nhớ.
Hnoh (dt)	Khe
Hnô (tt)	1. Heãnh bầu dục.
	2. Đền bù.
Hnơ̆ng (dt)	1. Mức độ. Djo\ hnơ\ng: đuông mức.
	2. Hnơ\ng êlan: Hệ thống.
	3. Hnơ\ng mâo hriăm: Treãnh độ văn hĩa.
Hnuă (gt)	Bên phải.
Hnuăt (dt)	Cái roi.
Hnuê (dt)	Ong mật.
Hnun (dt)	Tã lót.
Hnuh (dt)	Cùm. Hnuh klo\ng: Gông cùm.
Hnui (dt)	Trễ
Hnuôr (dt)	Khuôc cây đã hạ xuống trên róy.
Hnŭk (tt)	Yên. Hnu\k ênang: Beãnh yên.
Hnưm (tt)	Sớm (mùa màng).
Hoh (phụ từ)	Đây
Hŏ (phụ từ)	Nheô
Hŏk (đgt)	Đỗ
Hŏng	I. (tt) 1.trống (trống trãi).
	2. Băôûng. Nhà làm băôûng gỗ: Sang nga\ ho\ng kyâo.
	Ii. (giới từ) với. Ho\ng ih hria\m? Anh học với ai?.
Hŏ kdŏng (tt)	Trống rỗng.
Hô (tt)	Thiếu
Hôč (đgt)	Huyôt sáo.
Hôk (dt)	Đơn vị đo chiều dài từ nách cho hết bàn tay duỗi thẳng.
Hông (dt)	Ong vò vẽ.
Hô̆(dt)	Thuyền.
Hơ hơp (tt)	Toang. Ba\ng bha\ po\k hơ hơp. Cánh cửa mở toang.
Hơi (phụ từ)	Này
Hơr (đgt)	Hơ. Hơr pui: Hơ lửa.
Hơ̆k (tt)	Vui.
Hra (dt)	Muối. 
Hrah (tt)	Đỏ.  
Hrah mda (tt)	Màu hồng. 
Hrai (đgt)	Rải
Hră (dt)	Giấy. Hra\ Kkiêng: Giấy khai sinh.
Hră m’ar (dt)	Giấy tờ.
Hrač (dt)	1. Gỗ dầu.
	2. (đgt): Tuốt (luôa).
Hrăm (hư từ)	Cùng. Nao hrăm: đi cùng.
Hrăng (đgt)	Nai nịt. Hra\ng k’iêng: Nịt lưng.
Hrăp (tt)	No
Hrĕ roh (đgt)	Phát dọn beãa róy.
Hri (đgt)	Mô phỏng tiếng ve kêu.
Hriăm (đgt)	Học. Hriăm hră: Học hành.
Hriê (đgt)	Đến. Hriê ti anei: đến đây.
Hriê kơ mdrŏng	Đang giàu lên.
Hriêl (dt)	Bùa
Hriêng (dt) 	Aõaén dụ. Bu\ bi hriêng: nói ẩn dụ.
Hriêt (tt)	Æt
Hrih (đgt) 	Làm pheôp.
Hrip (đgt)	Hít. 
Hrĭl (dt)	Con keôt mỏ đỏ (giống con vẹt).
Hrŏ (đgt)	Giảm. Hro\  kyø: Giảm cân.
Hrŏng  (tt)	1. Hớt
	2. Lựa
Hrŏng  kƀĭn (đgt)	Tổng kết.
Hrô 	I.(đt) cái then.
	Ii.(đgt) 1.thay thế. 
	            2. Xâu
Hrôk (dt)	Cái đó (để băt cá) .
Hrông (tt)	1. Hoang. Lăn hrông: đất hoang.
	2. Nguyên vẹn.
Hrơ̆ng (đgt)	Cheôm. Hrơ\ng mgăn: cheôm ngang.
Hruê (dt)	Ngày.  
Hrua = hrô (đgt)	Thay thế.
Hruê̆ (dt)  	Cây thân dây
Hruh (dt)	1. Eøaé
	2. Bao
Hrui (đgt)	Thu về.
Hrut (đgt)	Co ruôt.
Hrut lăn (đgt)	Hít đất.
Hua (đgt)	Keôo lê.
Huă (đgt)	Aûn (ăn cơm).
Huăk (đgt)	Móc
Huăn (tt)	Khít. Hua\n mdua\n: Vừa khẳm
Huĭ (đgt)	Sợ.
Huĭ dah (đgt)	E răôûng.
Huič (đgt) 	 Huôp.
Hung, hung hang (đgt) 	Háo
Hung hang (tt)	Bất kham
Hur har (tt)	Nhiệt teãnh.
Hŭl (đgt)	Hấp hơi; Hấp cách thủy
Hŭt (tt)	Trật
Hưn (đgt)	Báo cáo.
Hưn akâo (đgt)	Đăng kyô.
Hưn mdah (đgt)	Giới thiệu. Hưn mdah klei soh: Thuô tội.
Hưn mthâo (đgt)	Thông báo.
Hưn phong (đgt)	Khoe khoang.
Hưp (đgt)	Ham. Hưp mdro\ng: ham giàu.
Hưt (tt)	Mát
Hwa (dt)	Vượn.
Hwak (đgt). Nh. Êwak	Vác.
Hwar (đgt)	Cào thành đống. Giê hwar: Cái cào.
Hwăt (đgt)	Lịm
Hwiă (đgt)	Thăt (dây thăt lưng)
Hwiê	I.(dt) mây
	Ii. (đgt) liệng đi
Hwiêt (đgt)	Teôm (tóc). GYØ hwiêt: Chải teôm.
Hyuă (đgt)	Chăôûng
Hyưt (tt)	Lo sợ.
H’aĭ(tt)	Không. Mrô h’ayø: Số (không).
H’ aĭ mang	Không có geã.
H’ ap (đgt)	Ngáp.
H’ ăp (tt)	Aõaém.
H’ ê̆č hmưi (đgt)	Chuôc mừng.
H’ iêng (đgt)	I. (đgt) cưng
  	Ii. (tt) quyô. Thâo h’iêng mnơ\ng yua: biết quyô đồ dùng.
H’ ĭt (đgt)	Yên tâm.
H’ô (đgt)	Mặc (áo).
H’ôk (đgt)	Đành lòng. Amâo h’ ôk dôk ôh. Không đành lòng ở lại.
H’ua (đgt)	Cà vào
H’uôn (đgt)	Thương yêu
H’ưi (đgt)	Thương tiếc.
	 
I	 
	 
Iăm (đgt)	Mô phỏng tiếng ve kêu.
I- ăk riăk (đgt)	Khuôc khích.
Iê (dt)	Anh rễ; chị dâu (nói chung).
Iê êkei (dt)	Anh rể.
Iê mniê (dt)	Chị dâu.
Iêp (đgt)	Gheô
Iêu (đgt)	Gọi. 
Iêu anăn (đgt)	Điểm danh. Kâo iêu anăn: tôi điểm danh.
Iêu jak (đgt)	Rủ rê.
Iêu mthưr (đgt)	Kêu gọi.
Iêu ung (đgt)	Rước rể (rước rể theo phong tục của người Êđê).
Ih (đại từ)	Anh
Ik ik (đgt)	Nài nỉ.
Ik rik	Lâm râm. 
Im (đgt)	Yểm (bùa). Mtâo im: Bị yểm bùa.
In (đgt)	Chơi.
In an (đgt)	Dựa sát vào người khác.
Injin (dt)	Cờ bạc.  
Ing ba k’ông	Rập reãnh (mô phỏng tiếng chiêng trống)
Ing tlam	Chạng vạng.
Iu (tt)	Thiu
Iŭ (đgt)	Thổi
	 
I	 
	 
I (dt)	Sơ sinh. Anak YØ: Trẻ sơ sinh.
Ir ĭr (tt)	Rừng rực (lửa cháy)
It uôt (tt)	Lề mề. Aáu yøt uôt êdi: Nó rất lề mề.
	 
J	 
	 
Jač (đgt)	Neôm. Ja] ]hiên mngan: Neôm cheôn bát.
Jah (đgt)	Phát. Jah rơ\k: Phát cỏ
Jak (đgt)	Mời
Jăk (tt)	1. Tốt
	2. Hay. Klei mmuyû hmư\ jăk: Bài hát này nghe hay.
Jam (dt)	Đĩa (để thức ăn). Dưm [e#yû hlăm jam: để bánh trong đĩa. 
Jang (tt)	Nhường. Kâo jang kơ ih: Tôi nhường cho anh.
Jao (đgt)	Giao. Jao bruă: Giao việc. 
Jar (dt)	Khung. Jar sang: Khung nhà. 
Jĕ (tt)	Gần. Sang kâo je\ sang hră: Nhà tôi gần trường học.
Jê (đgt)	Giăôûm. Jê tro\ng: Giăôûm cà.
Jê̆č (tt)	Vội. Kâo hlăk  je#]: Tôi đang vội.
Jê̆ñ (pht)	Thường xuyên. Aáu je#YÛ ]uă amyø ama: Nó thường xuyên thăm cha mẹ.
Jet jot (tt)	Xiêu vẹo. Sang jet jot: Nhà xiêu vẹo.
Jhar pui (đgt)	Bỏ thêm củi vào bếp.  
Jhat (tt)	Hỏng
Jheh jhoh (tt)	Chồm hỗm.  
Jhĭt (đgt)	Khâu. Amyø jhyøt ao: Mẹ khâu áo.
Jhô (đgt)	Luồn
Jhŏng (tt)	Dữ. Aáu ngă jho\ng : Nó làm dữ.
Jhut jhut (tt)	Treã trệ. Mă bruă jhut jhut  êdi: Làm thật treã trệ.
Jhŭk jhŭk (tt)	Hùng dũng. }huang êbat jhu\k jhu\k: Bước đi hùng dũng.
Jhưng (dt)	Giường
Jia (dt)	Thuế. Nao hrui jia: đi thu thuế.
Jiă	I.(tt) 1.nhiễm. Eùa jiă ]ho\: nước nhiễm bẩn. 
	 
	Ii. (đgt) nheôt. Jiă hăt hlăm đyøng hăt: nheôt thuốc vào tẩu thuốc.
Jiăng (tt)	Bạn bè trai thân nhau (gọi là jiăng). Y- Tin jing jiăng kâo: Y - Tin là bạn thân của tôi.
Jiêk (đgt)	Nheôt. Jiêk hlăm bai: Nheôt vào giỏ.
Jih (đgt)	Hết. Jih braih leh: Hết gạo rồi.
Jih jang (đt)	Tất cả.
Jik (đgt)	Làm
Jing 	I. (đgt) là. Aáu jing sa ]ô knuă druh knhâo: nó là một cán bộ giỏi. 
	 
Jĭng jai (tt)	Tạm thời. Kâo mă bruă jyøng jai ti anei: Tôi làm việc ở đây tạm thời. 
Jip jap (tt)	Nhếch nhác. Pưk sang jip jap: Nhà cửa nhếch nhác.
Joh (đgt)	Góy. Joh êgei: Góy răng.
Jông (dt)	Buôa (bổ củi). Jông blah djuh: Buôa bổ củi.
Jơ̆ng (dt)	Chân. Jơ\ng kngan: Chân tay.  
Jŭ (tt)	Đen. Ju\ ao: aoûo đen. 
Juă (đgt)	Đạp. Juă djo\ jơ\ng: đạp truông chân. 
Juăt (pht)	Quen. Kâo juăt huă kngan điâo: Tôi quen ăn tay trái. 
Juê (dt)	Lõi (lõi chuối). {ơ\ng juê mtei: aûn lõi chuối.  
Juh (đgt)	Dỗ. Juh adei: Dỗ em. 
Juh lia (đgt)	An ủi.  Juh lia aduôn: An ủi bà.
Juh alum (đgt)	Dỗ dành. Juh alum anak: Dỗ dành con.
Juih (dt)	Cái chĩa (đâm cá). Juih tlo\ kan: Cái chĩa đâm cá.
Juk tô (dt)	Bạn nữ thân thiết nhau (gọi nhau là Juk tô). H’ Tim jing juk tô kâo: H’ Tim là bạn thân của tôi.
Jŭm dar (tt)	Xung quanh. Ju\m dar sang hră mâo mnư\: Xung quanh trường có hàng rào.
Jung (đgt)	Deãu. Amiêt jung aê đyø kơ sang: Chuô deãu ông lên nhà.
Jur (đgt)	Rót (từ ống
	 
K	 
	 
Ka (pt)	Chưa. Kâo kă huă: Tôi chưa ăn.
Kă (đgt)	Buộc. Ayo\ng kă êmô hlăm war: Anh buộc con bò trong chuồng.
Kač (đgt)	Khăc vẽ. Amai kâo thâo ka]: Chị tôi biết khăc vẽ.
Kah (đgt)	Chia rẽ .  
Kah mbha (đgt)	Phân chia. Kah mbha kah mbha braih: Phân chia gạo.
Kahan (dt)	Lính
Kahan ƀuôn (dt)	Dân quân tự vệ. Ayo\ng kâo ngă kahan [uôn: Anh tôi làm dân quân tự vệ.
Kahan roh (dt)	Quân giặc
Kai (đgt)	Cày. Ama nao kai lo\: Bố đi cày ruộng.
Kaih (dt)	Vảy. Kaih kan: Vảy cá.
Kak (dt)	Chứng minh nhân dân. Hră kak: Giấy CMND.
Kal (đgt)	Cài. Kal [ăng bhă: Cài cửa.
Kam (dt)	Trấu.  
Kan(dt)	Cá. Kan bư: Cá quả. Kan êa ksyø: Cá biển. Kan ngư: Cá ngừ. Kan mtah: Cá tươi. Kan krô: Cá khô.
Kang (dt)	Căôûm. Mlâo kang: Râu căôûm.
Kar	I.(dt) ca. Kar tuah êa: ca muôc nước.
	Ii.(đgt) lọc. Kar êa: lọc nước.
Kar kak (dt)	Đế quốc. 
Kăl sŏng (dt) (Pr)	Quần đùi.
Kăm (đgt)	1. Kiêng. Ruă êhu\ng kăm [ơ\ng amre#]: đau dạ dày kiêng ăn ớt.
                                 	2. Cấm. Kăm amâo dưi lua mnah hlô mnơ\ng: Cấm không được săn băn thuô rừng.
Kăm ênoh (đgt)	Định giá. Kâo kăm ênoh kơ êmô anei: tôi đã định giá cho con bò này.
Kăn 	Không. Aáu amâo nao kâo kăn nao: Nó không đi tôi cũng không đi.
Kăp ƀŭk (đgt)	Căt tóc. Ama thâo kăp [u\k: Bố biết căt tóc.
Kăp (đgt)	Đón lõng. Arăng kăp mă phung tle\: người ta đón lõng băt bọn ăn trộm.
Kăp dlăng (đgt)	Để xem. Kăp dlăng si yûu ngă?: để xem nó làm thế nào?
Kâo (đt)	Tôi (ngôi thứ nhất số ít). Kâo dôk kơ sang: Tôi ở nhà.
Kba (tt)	Nhạt. Kpiê ]eh anei kba leh: Rượu cần này nhạt rồi.
Kban (dt)	Cái cầu. Kban găn êa krông: Cái cầu vượt sông.
Kbao (dt)	Con trâu.  
Kbâo (dt)	Mía.  
Kbhoh (tt)	Bọt.  
Kbiă (đgt)	Ra. Kbiă ti êngao: Ra ngịi.
Kbin (dt)	Cái chõ. 
Kblăm, kbluôm (đgt)	Nuốt chửng.  
Kbruč (tt)	Tíc. Kdô kphê kbru]: Bao cà phê bị tíc.
Kbŭm (đgt)	Ngậm. Kbu\m êsei: Ngậm cơm.
Kbŭm ênah	Mưng mủ. Anôk êka kbu\m ênah: Vết thương bị mưng mủ (căng mủ).
Kbuôn (dt)	Đồi. Kbuôn hlang: đồi tranh.
Kbưi (tt)	Xa. Aáu nao kbưi leh: Nó đã đi xa.
Kƀah (tt)	Thiếu. K[ah êsei huă: Thiếu cơm ăn; K[ah klei thâo: Thiếu sự hiểu biết.
Kƀăk (đgt)	Treo (măc vào). K[ăk ao ti ktai: Treo áo trên sào.
Kƀăt (tt)	Xinh đẹp.
Kƀao (dt)	Cái bào.  
Kƀeh (đgt)	1. Lể. K[eh êruê: Lể gai.
                                  	2. Mẻ. }hiên k[eh: Cheôn mẻ.
Kƀei (dt)	Cái bay.  
Kƀê̆ñ (đgt)	Rèn. K[e#n wăng: Rèn cuốc.
Kƀiêk ală (dt)	Khóe  măt.  
Kƀĭn (đgt)	Họp
Kƀla (tt)	Nhát. Asâo mrâo ba wyøt kơ sang adôk k[la snăk: Con chó 
	Mới mang về nhà còn nhát lăm.
Kƀôč (dt)	1. Duôm. Sa k[ô] braih: Một duôm gạo.
	2. Mỏ (gà
Kƀu (dt)	Xà phòng.
Kƀuê (dt)	Môi. K[uê mia êa hrah: Môi đánh son (môi son).
Kƀut (đgt)	Vun. Bi k[ut sa byøt: Vun một chỗ.
Kčah (đgt)	Hẹn. K]ah hruê tuôm: Hẹn ngày gặp.
Kčaĭ (đgt)	Băn tung tóe; eùa k]ayø: Nước băn tung tóe.
Kčăt (đgt)	Nheôo.  
Kčeh (đgt)	Nở (trứng nở ra con). Mnu\ krăm boh k]eh êđai leh: Gà ấp trứng nở con rồi.
Kčĕ bruă (đgt)	Tham mưu
Kčĭk (dt)	Cẳm xe. Ana k]ik jing kyâo yuôm: Căûm xe là loại gỗ quyô.
Kčoh (đgt)	1. May. K]oh ao: May áo. 
	2. Băm. K]oh ]yøm u\n: Băm thịt heo.
Kčŏ (dt)	Chấm. Gru k]o\: Dấu chấm; Gru k]o\ êmuh: Dấu chấm hỏi.
Kčuh (đgt)	Nhổ. K]uh êa bah: Nhổ nước miếng.
Kčŭng kčê̆ñ (tt)	Nhăn nheo.
Kčưm (đgt)	Mở đầu. K]ưm klei blu\: Lời mở đầu.
Kčŭt (đgt)	Chọc
Kčŭt kđi (đgt)	Khiếu kiện. Arăng bi k]u\t kđi: Người ta khiếu kiện nhau.
Kdaih (đgt)	Rành. Blu\ kdaih klei Êđê: Nói rành tiếng Êđê.
Kdăt (đgt)	Nhảy. Kdăt klei: Nhảy dây; Kdăt dlông: Nhảy cao.
Kdê (tt)	Co ruôm lại. Anôk lu mnuih yûu kdê he\: Nơi đông người nó co ruôm lại.
Kdlăk (đgt)	Sặc (sặc sụa).
Kdloh (đgt)	Tuột.  Wăng kdloh: Cuốc bị tuột ra.
Kdô (dt)	Tuôi. Kdô ao: Tuôi áo
Kdŏ (đgt)	Muôa.
Kdơ̆ng blah (đgt)	Kháng chiến. Klei kdơ\ng blah Mi: Cuộc kháng chiến chống Myoä.
Kdơ̆ng wĭt (đgt)	Chống trả. Kdơ\ng wyøt ho\ng phung roh: Chống trả bọn giặc.
Kdŭn (đgt)	Lùi. 
Kdrăn bi mblah (dt)	Chiến trường. Kdrăn bi mblah ti lăn dăp kngư: Chiến trường Tây Nguyên.
Kdrăn (dt)	Bãi. Kdrăn rơ\k: Bãi cỏ.
Kdưt (đgt)	Nhảy cóc (bỏ qua).  
Kdrăp (dt)	Trang phục; Kdrăp m’iêng ao Êđê: Trang phục váy áo Êđê.
Kdrê̆č (dt)	Đoạn
Kdriêk čar (dt)	Huyện. Kdriêk ]ar Krông Ana: Huyện krông Ana.
Kdruă (dt)	Vung
Kdruêh đưm (dt)	Truyền thống. 
Kdrưh k’ang (tt)	Vẻ vang. Kdrưh k’ang êdi lyøng kahan Awa Hồ: Bộ đội cụ Hồ thật vẻ vang.
Kđah (đgt)	Gặm. Asâo kđah klang: Chó gặm xương.
Kđao (dt)	Khuyoãu chân. Kđao jơ\ng: Khuyoãu chân.
Kđăl  (đgt) 	Đóng. Kđăl [ăng bhă: đóng cửa.
Kđăl mnŭ (dt) 	Mề gà.  
Kđăm gru (đgt)	Đóng dấu. Kđăm gru knơ\ng bruă: đóng dấu cơ quan. 
Kđĕ asâo (đgt)	Kêu chó.
Kđiêng (dt)	Ngón. Kđiêng kngan: Ngón tay.
Kđi čar (tt)	Chính trị. Lăn ]ar Việt Nam mâo kđi ]ar êđăp ênang: đất nước Việt Nam có nền chính trị ổn định.
Kđŏng (tt)	1. Dỏng. Asâo kđo\ng ku groh: Con chó dỏng đuôi sủa.
	2. Cong. Blu\ kđo\ng wăt kbuê: Nói điệu cong cả môi. 
Kđông	I (dt) đồn. Đđông kahan mgang knôg la\n: đồn biên phòng.
	II (đgt) chửa (con vật).
Kđhĭt (đgt)	Nháy. Kđhyøt ală: Nháy măt.
Kđuh (dt)	I. (dt) phên. Mtih sang pơ\ng ho\ng kđuh: vách nhà đóng băôûng phên.
	Ii. (đgt) giũ. Kđuh ayûuê abăn: giũ chăn chiếu.
Kđul (dt)	Gót. Kđul jơ\ng kâo kđang: Gót chân tôi bị nẻ.
Keh 	I. (đgt) hất. Keh đue# anôk mkăn: hất đi chỗ khác.
	Ii. (tht) uoùa. Keh! Kâo myøn ih nao leh: uoùa! Tôi tưởng anh (chị) đi rồi.
Keh koh (tt)	Mâu thuón. Ayo\ng adei đăm mâo klei keh koh ôh: Anh em đừng gây sự mâu thuón.
Keh nač (tt)	Ganh tị.
Kĕ (đgt)	1. Căn. Asâo ke\  jơ\ng yûu: Chó căn chân nó. 
                                  	2. Đốt. Ke#] ke\  ba kman ruă: Muỗi đốt truyền bệnh.
Kê̆č (dt)	Muỗi.
Kê̆ñ rô (dt)	Cầu vồng. Leh hjan khăng mâo ke#YÛ rô: Sau cơn mưa thường xuất hiện cầu vồng. 
Kgă (dt)	Xà gạc. Ama mâo sa [e\ kgă: Bố có cái xà gạc.
Kgâo (dt)	Con gấu. Rông kgâo mă phyø pioh mdrao klei ruă: Nuôi gấu lấy mật để chữa bệnh.
Kgông (đgt)	Gặm
Kgŭ (đgt)	Dậy. Kâo kgu\ pyøt: Tôi thức dậy.
Kgŭ dơ̆ng (đgt)	Đứng lên.
Khan (đgt)	Kể chuyện (theo nói vần). Aê kâo thâo khan Dam Săn: eøng tôi biết kể chuyện Dam Săn.
Khă (trơü từ)	Dù. Khă dleh dlan dưn kâo ăt gyør ktưn mơh: Dù khó khăn tôi vón cố găng. 
Khă dah (trt)	Mặc dù
Khăm (yu)	Khám. Kâo ba anak kơ aê êa drao khăm: Tôi đưa con đến bác sĩ khám.
Khăng 	I.(tt) cứng. Khăng mse\ boh tâo: cứng như đá.
	Ii.(pht) thường. Tlam
Khăng yua (trt)	Thông dụng
Khăp (đgt)	1.Yêu. Khăp kơ lăn ]ar: Yêu Tổ quốc. 
                                  	2. Thích. Khăp [ơ\ng đio\: Thích ăn xôi.
Khăp h’iêng (đgt)	Yêu thương. Khăp h’iêng hdăng ayo\ng adei: Anh em yêu thương nhau.
Khăt (đgt)	Căt. Kâo nao khăt [u\k: Tôi đi căt tóc.
Khê̆č (dt)	Trung quốc.
Khil đao (dt)	Gươm đao.
Khŏ (tt)	Điên. Eùkei kho\: thăôûng điên.
Không (tt)	Tạnh. Adiê không hjan leh: Trời tạnh mưa rồi.
Khu (tt)	Rát. Jơ\ng êka mia êa drao khu snăk: Chân bị thương bôi thuốc rát lăm.
Khua (tt)	1.Trưởng. Ama H’Ran jing khua [uôn: Bố H’ Ran là trưởng làng. 
	2. Già.  Ktơr anei khua leh: Băp này già rồi.
	3. Người lãnh đạo cơ quan
Khua bi ala (dt)	Đại biểu quốc hội. 
Khua čar (dt)	Chủ tịch tỉnh.
Khua gĭt gai đaíng (dt)	Bí thư.
Khua knŭk kna (dt)	Thủ tướng Chính phủ. 
Khua lăn čar (dt)	Chủ tịch Nước. 
Khut khat (trt)	Tuyệt đối
Khua mil čhil (dt)	Tổng thống.
Khua yang (dt)	Chuôa.  
Khuôt (dt)	Cạn.
K’iăng khua gĭt gai Đảng	 
Ki (dt)	Sừng. Ki kbao: Sừng trâu.
Ki mda (dt)	Nhung
Kiă (đgt)	1. Chăn. Kiă êmô: Chăn bò. 
                                  	2. Trông. Kiă sang: Trông nhà.  
Kiă dlăng (đgt)	Trông nom. Kiă dlăng phung hđeh: Trông nom bọn trẻ.
Kiă kriê (đgt)	1. Giữ geãn. Kiă kriê jăk mnơ\ng yua mbyøt: Giữ geãn của chung.
	2. Chăm sóc. Kiă kriê đang phê: Chăm sóc vườn cà phê.
Kiă răng mblah (đgt)	Trực chiến.  
K’iêng (dt)	Hông.   
Kih (đgt)	Queôt. Kih sang: Queôt nhà.
Kjač (đgt)	 
Kjač mŭt (đgt)	Lao vào.
Kdjăt (đgt)	Giật. Kdjăt asei mlei: Giật meãnh. 
Kdjăt ñhăr	Giật thót. 
Kjăp (tt)	Chăc (vững). Sang anei dlăng kjăp êdi: Nhà này trông rất chăc.
Kjăp mră (tt)	Vững chăc.
Kjham (tt)	1.Nặng. Ruă kjham: Bệnh nặng.
	2. Trầm trọng. Klei bruă anei jing kjham leh: Sự việc này đã trở nên trầm trọng.
Kjoh (đgt)	Bẻ. Kjoh mdua: Bẻ làm đôi.
Kjhôč lăn (dt)	Mũi đất.  
Kjơ (dt)	Cái cào.
Kju  (dt)	Cây giáo. Aê kâo mâo kju: eøng tôi có cây giáo.
Kjuh (sôú từ)	Bảy. Kjuh hruê mlam: Bảy ngày đêm.
Kjŭk (đgt)	Chọc lỗ  tỉa luôa.
Kdjŏng (đgt)	Nhấc. Kdjo\ng klo\ boh tâo: Nhấc tảng đá.
Kdjô̆(đgt)	Gáy. Mnu\ kdjo#: Gà gáy.
Kdjơt (đgt)	Nhón. Aáu kdjơt jơ\ng ]iăng kơ dlông: Nó nhón chân để cho cao.
Kdjuôt (tt)	Heôo
Kkaih (dt)	Gầu (gầu tóc
Kkâo (dt)	Móng
Kkăl (tt)	Đục. Eùa krông kkăl plu\k: nước sông đục ngầu.
Kkiêng (đgt)	1. Sinh
	2. Góc
Kkiêng kngan (dt) 	Khuyoãu tay. 
Kkuh (đgt)	Chào. Sang hră kâo khăng kkuh hla kơ grăp knăm sa: Trường tôi thường chào cờ vào ngày thứ hai; Kkuh nai mtô: Chào thầy cô (giáo viên).
Kkuê (dt)	Cổ. Kâo êgah kkuê: Tôi mỏi cổ.
Kkui (đgt)	Cuôi xuống. Kâo kkui mă giê ]ih: Tôi cuôi xuống lấy buôt viết.
Kkuih (dt)	Con chuột. Kkuih bi rai guê lo\: Con chuột phá hoại bờ ruộng.
Kkuih hyăp (dt)	Chuột đồng. Kkuih hyăp [ơ\ng kđeh jăk snăk: Chuột đồng ăn rất ngon.
Kkuih nuôt (dt)	Chuột nhăt. 
Kkung (đgt)	Khiêng. Phung êkei kkung kmeh sang: đàn ông khiêng cột nhà.
Kla (tt)	Hói.  
Klah (đgt)	Tách.  
Klah čŭn(trt)	Tóm tăt. Klah ]u\n klei hriăm anei: Tóm tăt bài học này. 
Klah klap (tt)	Riêng lẻ.  
Klam (đgt)	Vác. Ayo\ng kâo klam djuh: Anh tôi vác củi.
Klang (dt)	Xương. Klang u\n: Xương heo.
Klang grưh (dt)	Xương sườn.
Klap (dt)	Con mối (mối có cánh bay rang ăn được).
Klă (tt)	Kyoä. Dlăng klă klei hrăm anei: đọc kyoä bài học này. 
Klă klơ̆ng (tt)	Rõ ràng.
Klăk jơ̆ng bê klê jơ̆ng ŭn (tng)	Yoû nói người không trung thực.
Klăm (tt)	Xui xẻo. Klăm leh yûu anăn: Nó bị xui xẻo rồi.
Klei 	I.(đgt) đào. Klei [ăng êa: đào giếng.
	Ii.(dt) 1. Dây. Amyø blei klei pui: mẹ mua dây điện. 
	2. Tiếng. Kâo hriăm klei Êđê: Tôi học tiếng Êđê. 
	3. Sự
Klei bi doh (dt)	Vệ sinh. Răng kriê klei bi doh: Giữ geãn vệ sinh.
Klei bi liê (dt)	Sự chi phí. 
Klei bhiăn (dt)	Phong tục. 
Klei bhiăn ala (dt)	Hiến pháp.
Klei bhiăn jăk siam	Truyền thống tốt đẹp. 
Klei blah ngă (dt)	Chiến tranh.
Klei duê (dt)	1. Ca dao. Yuăn mâo lu klei duê: Người Kinh có nhiều ca dao.  
	2. Bài thơ. Klei duê  anei hmư\ jăk: Bài thơ này nghe hay.
Klei dưi blah ngă (dt)	Cuộc chiến thăng lợi
Klei dưi mil čhil mơ̆ng pô (dt)	Quyền tự chủ.  
Klei đup gưt (dt)	Sự lễ pheôp. Hđeh hriăm hră mâo klei đup gưt: Học sinh có sự lễ pheôp.
Klei đưm đă (dt)	Chuyện đời xưa. Aduôn yăl dliê klei đưm đă kơ kâo: Bà kể chuyện đời xưa cho tôi.
Klei êđăp ênang mgang ala (dt) 	   An ninh Quốc phòng.
Klei êngiê (dt)	Độc lập. Lăn ]ar drei leh mâo klei êngiê: đất nước ta đã được độc lập.
Klei hdĭp (dt)	Đời sống
Klei hgŭm đru (dt)	Sự tương trợ. 
Klei mưng juăt (dt)	Thói quen. Aáu mâo klei juăt khăng kgu\ pyøt ưm: Nó có thói quen  thường thức dậy sớm.
Klei khan (dt)	Trường ca. Klei khan Dam Săn: Trường ca Dam Săn.
Klei khăp čiăng (dt)	Sở thích. 
Klei kiă kriê (dt)	1. Sự cai trị. Klei kiă kriê mơ\ng phung kar kak: Sự cai trị của bọn phong kiến. 
	 2. Sự chăm sóc. 
Klei kriê čuăn (dt)	Nội quy. Jih jang hđeh hriăm hră bi hluê ngă jăk klei kriê ]uăn sang hră: Tất cả học sinh phải thực hiện tốt nội quy của nhà trường.
Klei kŭp dăp (dt)	Trò trốn teãm.
Klei pơ̆k mñam (dt)	Việc đan lát. 
Klei suaih pral(dt)	Sức khỏe. }iăng mâo klei suaih asei grăp ]ô mnuih kriăng ep mjuăt asei mlei: Muốn có sức khỏe mỗi người phải năng tập thể dục.
Klei soh (dt)	Tội lỗi.  
Klei yăl dliê (dt)	Câu chuyện
Klei yăl dliê đưm (dt)	Truyện cổ tích.  
Klei ruă duam (dt)	Bệnh tật. Tơ dah amâo thâo răng klei doh syøt nik mâo klei ruă duam: Nếu không biết giữ geãn vệ sinh chăc chăn có bệnh tật.
Klei thâo săng (dt)	Sự hiểu biết.
Klei tŭ dưn (dt)	Thành quả
Klei truh (dt)	Teãnh heãnh
Kleh (đgt)	Cởi ra
Klia êlan (đgt)	Uoùi đường. Eùdeh ]uk klia êlan: Xe ủi
Kliăng (dt)	Cheãa khĩa. Kâo nao ngă kliăng êdeh: Tôi đi làm cheãa khĩa xe.
Kliêng pruê̆ bi kpă	Gióng hàng cho thẳng.
Klih (tt)	Keo. Aáu klih snăk: Nó keo lăm.
Klih ñơ ñă (tt)	Keo kiệt. 
Klĭt (dt)	Da.
Klĭt kliêng (dt)	Da dẻ.
Kluôm dhuôm (dt)	Tịn bộ
Klư̆ kliă (đgt)	Xô đẩy. Đăm bi klư\ kliă ôh: đừng xô đẩy nhau.
Klư̆, klưng (đgt)	Xô
Kma muê (đgt)	Thụ phấn.
Kmah (tt)	Hào phóng.
Kman (dt)	Vi trùng. Kman ba tưp klei ruă: Vi trùng truyền bệnh.
Kmang (dt)	Mào gà.
Kmiêk (đgt)	Eøm.
Kmlô (tt)	Câm. Kmlô amâo thâo blu\: Câm không biết nói.
Kmrơ̆ng (dt)	Rừng. Hlăm kmrơ\ng mâo lu hlô: Trong rừng có nhiều thuô rừng.
Kmrơ̆ng dhông (dt)	Rừng nuôi. Kdriêk ]ar eùa sup adôk mâo lu kmrơ\ng dhông: Huyện eùa sup còn có nhiều rừng nuôi.
Kmruôt (dt)	Ong ruồi. Kmruôt du] amâo ruă: Ong ruồi chích không đau.
Kmuôt tlan (dt)	Giun sán. {ơ\ng huă ]ho\ mro\ syøt nik mâo kmuôt tlan: aûn uống dơ bẩn chăc chăn có giun sán. 
Kmŭn (dt)	Kmu\n gơ\ng: Dưa leo. Hma Êđê đưm khăng pla kmu\n êa: Róy Êđê xưa thường trồng dưa nước; Kmu\n tuk: Dưa gang. 
Kmŭt (dt)	Buôa (đóng đinh). Ama mă kmu\t pơ\ng săk kđiyû: Bố lấy buôa đóng đinh.
Knai (dt)	Anh em họ (anh em trai có họ hàng với nhau gọi là knai).
Knaih (dt)	Thợ rèn.
Knap (tt)	Khổ. Mnuih [uôn sang ti kryøng taih kbưi adôk knap: Người dân ở vùng sâu
Knap mñai (tt)	Khổ cực. Knap myûai amâo djăp êsei huă: Khổ cực không đủ cơm ăn.
Knam (dt)	Mây đen. Tlam anei
Knam hjan (dt)	Mây mưa. Knam hjan hlăk truh
Knăm (dt)	Thứ. Knăm sa: Thứ hai.
Knăt (dt)	Đọt
Knhăk (tt)	Tài. Ayo\ng kâo knhăk đyø kyâo: Anh tôi tài leo cây.
Knhâo mbruă (tt)	Giỏi giang
Knhông(tt)	Lăôïng lơ.
Knhuk knhul (đgt)	Đua đòi.
Kniă (tt)	Chật. Ao anei h’ô kniă êdi: Aoûo này mặc rất chật.
Kniă kniêt (tt)	Chật chội. Pưk sang di yûu kniă kniêt: Nhà cửa của họ chật chội.
Knĕ (đgt)	Aûn trộm. Eùkei kne\: thăôûng ăn trộm.
Knga (dt)	Tai. Knga pioh hmư\: Tai để nghe.
Kngan (dt)	Tay.
Kngăl (tt)	Điếc.  
Kniêm (dt)	Máng. Kniêm u\n: Máng heo.
Knip (dt)	Dế mèn.  
Knguôr (dt)	Cái nia. Knguôr pioh [hu mdiê: Cái nia để phơi luôa. 
Kngư (tt)	Dốc. Đyø kngư: Lên dốc.
Knŏng (phoï từ)	Chỉ có. Kno\ng hjăn kâo nao: Chỉ có một meãnh tôi đi.
Knô (tt)	1. Đực. Eùmô knô: Con bò đực.
	2. Trống. Mnu\ knô: Gà trống.
Knông lăn (dt)	Biên giới
Knơ̆ng bruă (dt)	1. Cơ quan. 
	2. Sở. Knơ\ng bruă ]ar pô: Sở Nội vụ; Knơ\ng bruă klông êlan: Sở Giao thông; Knơ\ng bruă mdrao mgu\n: Sở Y tế; Knơ\ng bruă mtô mjuăt: Sở Giáo dục; Knơ\ng bruă ngăn prăk:  Sở Tài chính; Knơ\ng bruă lo\ hma leh anăn mđyø kyar [uôn sang:  Sở Nông nghiệp và Phát triển nông thôn. 
	3. Cục. Knơ\ng bruă jia ]ar: Cục thuế tỉnh.
Knơ̆ng bruă čar 	Tỉnh ủy.
Knuăk (dt)	Cái móc. Knuăk ]hum ao: Cái móc quần áo.
Knuê(trt)  	Luôc nãy
Knuih (dt)	Uy
Knuih khưm (tt)	Uy tín.
Knuih kniêng (dt)	Tính teãnh.
Knur (tt)	Nhọn. Giê knur: Cây nhọn.  
Knŭk kna (dt)	1. Chính phủ. Knu\k kna Việt Nam: Chính phủ Việt Nam. 
	2. Nhà nước. Knu\k kna mđing dlăng klei hdyøp mnuih [uôn sang: Nhà nước quan tâm đến đời sống của nhân dân.
	3. Chính quyền.
Knŭng (dt)	Lộc vừng. Ana knu\ng: Cây lộc vừng.
Kñĭ (tt)	Màu vàng. Hla kơ hrah mtu\ kyûyø: Lá cờ đỏ sao vàng.
Kñĭt (dt)	Nghệ. KYÛYØ mse\ kyûyøt: Vàng như nghệ.
Kñŭl (dt)	Điều. Ana kyûu\l: cây điều.
Koh (đgt)	Chặt. Ama koh djuh: Bố chặt củi.
Kŏ (dt)	Đầu.
Kông  (dt)	Vòng. Buh kông: đeo vòng.
Kô̆(tt)	Trăng. Ao ko#: Aoûo trăng.
Kơ 	(Giới từ). Nao kơ hma: đi róy; Khăp kơ amyø ama: Yêu cha mẹ; Kâo brei kơ yûu hdruôm hră hriăm klei Êđê: Tôi cho nó quyển sách học tiếng Êđê.
Kơ êdei 	Sau này. Hriăm hră bi jăk pioh jing mnuih tu\ dưn kơ êdei: Học hành cho tốt để trở thành người có ích sau này.
Kpa(dt)	Con ba ba. Arăng rông kpa: Người ta nuôi ba ba.
Kpaih (dt)	Bông. Kpaih pioh êwei mrai: Bông để keôo sợi.
Kpal (tt)	Dày. 
Kpă ênuah (tt)	Thật thà.  
Kpăk (tt)	Bận. Kâo kpăk bruă: Tôi bận việc.
Kpăt (đgt)	Năm. Kpăt kngan: Năm tay.
Kpei 	I. (dt) men. Kpei pioh knă kpiê: men để nấu rượu.
	Ii. (đgt) sàn sẩy.
Kphê (dt)	Cà phê. 
Kpiê (dt)	Rượu. Kâo khăp mnăm kpiê ]eh: Tôi thích uống rượu cần.
Kpiê ruă čuă êba (tng)	Yoû nói say xỉn.  
Kpin (dt)	Cái khố. Đưm êlâo êkei Êđê [ar kpin: Ngày xưa người đàn ông Êđê mặc khố.
Kpit (đgt)	Bóp. Kpit boh [ơr dlăng ksă leh ka?: Bóp quả bơ xem chín chưa?.
Kpĭ (đgt)	Kẹp. 
Kplăk (đgt)	Giật (giành giật). Kplăk mă: Giật lấy.
Kplŏng (đgt)	Nhảy (nhảy lên). Kplo\ng pah boh: Nhảy đập bóng.
Kplŭk (tt)	Dập nát ( đám hoa màu
Kpơ̆ng (dt)	Gốc ( Gốc cây bị gãy còn nửa dưới đất và nửa trên mặt đất). 
Kpơ̆ng adrăng  (dt)	Gốc rạ. Leh wiă kdrăn lo\ adôk kno\ng kpơ\ng mdiê: Cánh đồng gặt xong chỉ còn gốc rạ.
Kpŭng (dt)	1. Bột. Kpu\ng pioh ngă [e#YÛ: Bột để làm bánh. 
	2. Phấn. Kâo mâo kpu\ng mia [o#: Tôi có phấn trang điểm.
Kpŭng ksu (dt)	Tuôi ni lông.
Kpư̆ hlư̆ (đgt)	Hoạt động.   
Kra (dt)	Con khỉ.  
Krah              	I. (dt). Nhón. Krah mah: nhón vàng.
                     	Ii. (đgt).vạc
Kral (đgt)	Nhận ra
Kram (dt)	Tre.   
Krao (đgt)	Rên. 
Krăm (đgt)	Aõaúp. Mnu\ krăm boh: gà ấp trứng.
Krăn (tt)	Tê. Krăn jơ\ng: Tê chân.
Kreh kruñ (tt)	Chăm chỉ
Krê̆č  (dt)	Chim sáo.  
Krê̆ñ (tt)	Tức giận. Ayo\ng adei đăm duah bi kre#YÛ: Anh em đừng tức giận nhau.
Kri (tt)	Quăn. {u\k kri: Tóc quăn.
Krĭ (đgt)	Vót.
Kriăng (tt)	Siêng
Kriêp (tt)	Im. 
Kriêp êyăng (tt)	Im ăng. Pưk sang kriêp êyăng amâo mnuih kmưn: Nhà cửa im ăng không có bóng người.
Krih (đgt)	Tưới. Kâo krih đang kphê: Tôi tưới vườn cà phê.
Krih êa drao	Phun thuốc. 
Krĭng (dt)	Vùng
Krŏng (dt)	1. Chông. Kryø kro\ng: Vót chông.
	2. Sâm sâm. Hla kro\ng: Lá sâm sâm.
Krông (dt)	Sông.  
Krua (dt)	Con rùa. Eùmưt mse\ krua: Chậm như rùa.
Krum (dt)	Gầm. Krum jhưng: Gầm giường.
Krŭ (dt)	Bò tót.  
Krŭ kdơ̆ng (dt)	Cách mạng.  
Krư̆ (đgt)	Nhốt
Ksă (tt)	Chín. Mtei ksă: Chuối chín.
Ksăk ksaĭ (tt)	Tứ tung.
Ksê (dt)	Con kiến dương.Yan hjan khăng mâo ksê: Mùa mưa thường có con kiến dương. 
Ksê eh (dt)	Con bọ hung. Ksê eh ]ho\ mro\ snăk: Con bọ hung rất bẩn.
Ksi (dt)	Cái lược. Ksi gyø [u\k: Lược chải tóc.
Ksiêm dlăng ( đgt)	Kiểm tra.
Ksiêm hgăm (dt)	Mật thám. Truă rup mnuih ksiêm hgăm: đóng vai mật thám.  
Ksiêm ruh (đgt)	Phê beãnh. }o\ng ksiêm ruh pô: Tự phê beãnh.
Ksir mtei (dt)	Nhánh chuối. 
Ksĭng (trtừ)	Giáp (giáp ranh).
Ksŏ (dt)	Phổi.
Ksơ̆k (dt)	Ma. Hđeh huyø ksơ\k: Bọn trẻ sợ ma.
Ksơr (dt)	Róy hoang.  
Ksu (dt)	Cao su. Ana ksu: Cây cao su; Asăr ksu: Hột cao su; Boh ksu tu\k djam: Quả su nấu canh.
Ksu lăm(dt)	Cục tẩy.
Ksua (dt)	Con nhím.  
Ksul (đgt)	Xới. Ksul êsei: Xới cơm. 
Ksŭk ksăk (tt)	Hào hứng.
Ksŭng (đgt)	1. Xông lên. Phung kahan ksu\ng blah roh: Bộ đội xông lên đánh giặc.
	2. Xuôc. Ksu\ng giêt êa: Xuôc beãnh nước. 
Ktah (dt)	Con đỉa. Aáuôt mse\ si ktah: Dai như đỉa.
Ktan ală (đgt)	Lườm măt.
Ktang (tt)	1. Mạnh. Bhyør ktang boh tuôr: Neôm mạnh quả cù.
	2. Khỏe. Kbao anei ktang snăk: Con trâu này rất khỏe.
Ktang kjăp (tt)	Vững mạnh. Ru\ mdơ\ng ala ]ar [rư\ hruê ktang kjăp hyøn: Xây dựng đất nước ngày càng vững mạnh hơn.
Ktang tĭt (tt)	Quyết liệt
Ktat mnŭ (dt)	Eøaé gà.
Ktar (đgt)	Khoan.  Ktar [ăng êa: Khoan giếng nước.  
Ktăl (đgt)	Ngứa. Eùbua ktăl: Môn ngứa; Ktăl ko\: Ngứa đầu.
Ktăk (dt)	1. Nhựa (cây). Ktăk mtei đuôm jiă ao: Nhựa chuối làm ố áo; 2. Mủ. Ktăk ksu: Mủ cao su.  
Ktăm ƀuôn (dt)	Reãa làng. Lo\ ti ktăm [uôn: Ruộng ở reãa làng.
Ktâo (dt)	Chấy
Ktâo asâo (dt)	Bọ cheôt chó.  
Ktăp kŏ (đgt)	Lộn đầu.
Kteh (đgt)	Lăc. Kteh ko\: Lăc đầu.
Kthuôt (dt)	Mụn cóc.
Kthŭl (tt)	Vụng về. Mniê kthu\l bruă pưk sang: Cô gái vụng về việc nhà cửa.
Ktiă (dt)	Con keôt.  
Ktlah (đgt)	Tách. Ktlah dôk mdê: Tách ở riêng.
Ktlaih (đgt)	Tuột. Ktlaih  jep: Tuột deôp.
Ktiu (đgt)	Mớ ngủ.
Ktĭng êgei (tt)	Eù răng. {ơ\ng boh msăm lu ktyøng êgei snăk: aûn nhiều quả chua ê răng lăm.
Ktŏng (dt)	Con mang.  
Ktôñ (dt)	Rau dương xỉ người Êđê làm rau nấu ăn.
Ktơr (dt)	Băp (ngô).  
Ktơ̆ng (đgt)	Sôi. Go\ êsei ktơ\ng leh:  Nồi cơm đã sôi rồi. 
Ktrai (đgt)	Thả. Ktrai yûuăl: Thả lưới.
Ktrăm jơ̆ng (đgt)	Dóm chân.
Ktrâo (đgt)	1. Chỉ. Ktrâo êlan kơ kâo đa: Chỉ đường cho tôi với; 
	2. Bồ câu. Rông ktrâo: Nuôi bồ câu.
Ktrâo mblang (đgt)	Chỉ Đón. Ktrâo mblang kơ mnuih [uôn ngă hră kkiêng: Chỉ Đón cho người dân làm giấy khai sinh.
Ktrei (dt)	Cái keôo. Ktrei khăt mnal: Keôo căt vải.
Ktrŏ (tt)	Nặng.  Kdô braih anei ktro\ êdi: Bao gạo này nặng lăm.
Ktuê êlan (trgt)	Dọc đường. Ktuê êlan
Ktuê̆ muôr (dt)	Gò mối. 
Ktuôp (dt)	Con cào cào.
Ktŭng (đgt)	Keôo. Ktu\ng klei: Keôo dây.
Ktŭt (đgt)	Đánh răm.
Ktut (đgt)	Dộng. Ktut giê dưh ]iăng bi mđơr: Dộng đũa cho đều nhau.
Ktưn (đgt)	Phấn đấu. Hđeh ktưn hriăm hră: Học sinh phấn đấu học tập.
Ktư̆ (đgt)	Đè. Boh tâo ktư\ kra gơ\ păt ]iăng djiê: hòn đá đè con khỉ gần chết.
Ktư̆ êyơ̆ng (tt)	Run
Ktư̆ juă (đgt)	Chà đạp
K’ul (tt)	Buồn nôn.
K’up (tt)	Rợp.
K’up k’ap (tt)	Rậm rạp.
 Ku (dt)	Cái đuôi.  
Kuač (đgt)	Cào cấu.
Kuai (đgt)	Moi. Kuai lăn: Moi đất.
Kuaih (đgt)	1. Gãi.
	2. Riềng.
Kuăl  (đgt)	Vòng. Kuăl kngan: Vòng tay. 
Kuat (đgt)	Cái quạt (chỉ quạt máy).
Kuêh (đgt)	Cạo. Kuêh mlâo kang: Cạo râu.
Kuê̆č (dt)	Phẩy.
Kuê̆ñ (dt)	Con vượn. Kue#YÛ dhyøp dlông kyâo: Con vượn thường sống trên cây.
Kuôp (dt)	Đài
K’ŭ kyăm	1. (dt) Ma chay. Klei k’u\ kyăm: Việc ma chay.
	2. (tt) Tương tư. Eùkei anăn mâo klei k’u\ kyăm: Chàng trai đó bị tương tư. 
K’ŭm (đgt)	Nướng băôûng lá (vùi tro). Kan phyø k’u\m [ơ\ng jăk: Cá đăng nướng băôûng lá vùi tro ăn ngon.
K’ŭt (dt)	Đầu gối.
K’ ŭl (đgt)	Luộc. K’ u\l djam hbei tao: Luộc rau lang. 
Kŭr (dt)	Cam pu chia. 
Kwă (đgt)	1. Xay. Kwă mdiê: Xay luôa. 
	2. Quay. Kwă thu\ng êa: Quay thùng nước.
Kwăt (dt)	Kẽm. Klei kwăt: Dây kẽm.
Kwang (tt)	Dội
Kwang dar (đgt)	Bao vây.  
Kwar čư̆ chiăng (dt)	Miền nuôi.  
Kwăr (đgt)	Khuấy. 
Kwưh akâo	Cầu xin.
Kyâo mtâo (dt)	Cây cối. Pla lu kyâo mtâo hlăm kbuôn ]ư\ kla: Trồng nhiều cây cối trên đồi trọc.
Kyâo yuôm (dt)	Gỗ quyô. Hlăm kmrơ\ng dliê mâo lu kyâo yuôm: Trong rừng có nhiều gỗ quôy.
Kyua (lt)	Veã. Kyua adiê hjan: Veã trời mưa.
Kyua dah (lt)	Bởi veã
	 
L	 
	 
La (dt)	Lá lách. Ruă la: đau lá lách.
La griêô (đgt) (Pr)	Biểu teãnh.
Lang (đgt)	Trải. Lang ayûuê: Trải chiếu.
Lač (đgt)	1. Nói. Amyø ama la] bi thâo gưt asăp: Bố mẹ nói phải biết vâng lời.
	2. Bảo. Kâo la] kơ ih: Tôi bảo anh.
Lai čhum ao (đgt)	Xả quần áo (giặt xả). 
Lak (dt)	Hăc lào.
Lam (dt)	Lưỡi lam.
Lap (tt)	Thoả thuê.
Lă (tt)	Bạc (bạc màu). 
Lăm (đgt)	Xĩa. Lăm klei ]ih ti jhưng ju\: Xĩa bài viết trên bảng đen.
Lăm lap (tt)	Gian lận.
Lăn (dt)	Đất. Lăn ngă hma: đất làm róy.
Lăn ala, lăn čar (dt)	Đất nước.  
Lăn dap mnai (dt)	Đồng băôûng.  
Lăn êa (dt)	Tổ quốc. Lăn êa Việt Nam: Tổ quốc Việt Nam.
Lăn kla (dt)	Đất hoang hĩa bạc màu. Lăn kla pla amâo thâo jing mnơ\ng: đất hoang hĩa bạc màu không trồng trọt được.
Leh (đgt)	Rồi.
Leh anăn (liên từ)	Và. Hruê anei lăn anăn hruê mgi: Hôm nay và ngày mai.
Lĕ (đgt)	1. Rơi. Kâo bi le\ giê ]ih: Tôi làm rơi cây viết. 
	2. Lặn. Yang hruê le\: Mặt trời lặn.
Lĕ buh (đgt)	Ngã.  
Lĕ bŭt (đgt)	Măc lừa. Kâo le\ bu\t kơ yûu: Tôi măc lừa nó.
Liê (tt)	Tốn.  
Lik (đgt)	Tan. Hra lik hlăm êa: Muối tan trong nước.
Lir (dt)	Dế trũi. Hjan mâo lu lir: Mùa mưa có nhiều dế trũi.
Ling (đgt)	Tràn. Eùa ling hlăm sang: Nước tràn vào nhà.
Lĭng kahan (dt)	Bộ đội
Lŏ 	1. (dt) Ruộng. Kai lo\: Cày ruộng.
  	2. (đgt) Lại. Aáu lo\ nao: Nó lại đi.
 	3. (phó từ): Nữa. Aáu amâo lo\ ]iăng huă: Nó không muốn ăn nữa.
Lŏ hblŏk (đgt)	Hối hận
Lŏ rŭ mdơ̆ng (đgt)	Khôi phục. Arăng lo\ ru\ mdơ\ng sang dlông Êđê: Người ta khôi phục lại nhà sàn Êđê.
Lŏ wĭt hriăm (đgt)	Eøn tập.
Lông (đgt)	Thử. Ih lông h’ô lăng ao anei: Chị (anh) thử mặc áo này.
Lu (tt)	Nhiều.
Luar (đgt)	Dối
Luê  (đgt)	Bơi. Hmei nao luê: Chuông tôi đi bơi.
Lui (đgt)	Bỏ. Lui he\ mnơ\ng jhat: Bỏ đi cái xấu.
Luh (đgt)	Rụng. Aduôn kâo luh jih êgai leh: Bà tôi đã rụng hết răng.
Luh liê (đgt)	Rơi rớt
Luêh ksua (dt)	Lông nhím.
Lun (đgt)	Nuốt.
Lung (dt)	Lứa.
Lŭč (đgt)	Mất. Aáu lu\] jep: Nó mất deôp.
Lŭč liê (đgt)	Tốn keôm. Ngă sang lu\] liê prăk êdi: Làm nhà tốn keöïm tiền bạc lăm.
Lŭk (đgt)	Trộn.
Lŭl (tt)	Dô. Adhei lu\l: Trán dô.
	 
M	 
	 
Mač mnŭ (dt)	Bọ mạt. Pông mnu\ mâo lu ma] mnu\: Chuồng gà nhiều bọ mạt.
Mah (dt)	1.Vàng. Krah mah: Nhón vàng; Mah klo\: Vàng la.ô 
	2. Con cưng. Wei lah mah kâo ah: eøi con cưng của mẹ. 
Mah jiăng (dt) 	Anh em kết nghĩa. {ơ\ng mah jiăng: Thề kết nghĩa anh em.
M’ai dhuai (tt)	Sung sức. Aáu hlăk m’ai dhuai: Nó đang sung sức.
Maĭ (dt)	Máy. Eùdeh mayø: Xe máy; mayø [uôp êa: Máy bơm nước; 
	Mayø kwă: Cối xay; mayø pleh ktơr: Máy tẻ ngô; mayø prah: Máy gặt; mayø puôt mdiê: Máy tuốt luôa.
M’ak(tt) 	Vui
M’ak hlak (tt) 	Thích thuô. Klei yăl dliê ngă kơ jih jang mnuih m’ak hlak:  Câu chuyện làm mọi người thích thuô. 
M’ak mñai (tt) 	Vui vẻ. Tuôm ho\ng di yûu
M’ak m’ưr (tt) 	Thuô vị. Dliê mnga m’ak mưr: Phong cảnh rất thuô vị.
Mal (dt) 	 Rui (Thanh tre đặt theo mái nhà).
Mam (đgt) 	Buô. Anak ]iăng mam: Con đòi buô. 
Man (tt)	Vừa. Man mơ\ ih ]u\t hdruôm jơ\ng: Anh mang giầy vừa không.
Man dưn (tt)	1. Vừa khít
	2. Vừa phải.
	3. Trung beãnh. Boh dlông man dưn: độ cao trung beãnh.
Man đŏk mbah (tt) 	Hợp khẩu vị.  
Man miăn	Không vừa đâu (phủ định). Ao anei man miăn: Aoûo này không vừa đâu.
Mañ (đgt) 	Mượn. Mayû êdeh: Mượn xe; mayû hdruôm hră: Mượn sách.
Mang (tt) 	1. Suông. Tu\k mang: Nấu suông (nấu không có thịt,cá). 
	2. Không làm việc geã
M’ar (dt) 	Giấy. Hla m’ar: Tờ giấy.
M’at (đgt)	Chườm. M’at êa hlơr: Chườm nước nóng.
Mă (đgt) 	1. Lấy
	2. Làm. Mă bruă: Làm việc.
Mă êa pui (đgt) 	 Khai thác dầu mỏ.
Măk (tt) 	Bướng bỉnh. Jing sa ]ô anak măk: Là một đứa con bướng bỉnh. 
Măk ƀai (tt) 	Tàn ác. Phung măk [ai: Bọn tàn ác.
M’ăng (tt) 	Độc địa. {ăng êgei m’ăng: miệng độc địa.
Măng ai tiê (tt) 	Vô kể.
Măng ai ñu (đgt)	Mặc kệ nó
Măng dah (pht) 	Đáng lẽ
Măl (đgt)	Bôi
Mâo (đgt) 	Có. Mâo prăk: Có tiền; Mâo sang mdê: Có nhà riêng.
M’âo (tt) 	Thương mến.
Mbah (dt) 	1. Miệng
	2. Meô cửa. Dôk ti mbah [ăng bhă: đứng neôp meô cửa. 
Mbăng (đgt) 	1. Nhờ vả. Ama ]ăm mbăng kơ amyø: Bố đánh chạy lại với mẹ. 
	2. Cứu giuôp. 
Mbeh (đgt)	Dời đi chỗ khác. Mbeh sang ti mkăn: Dời nhà ra chỗ khác.
Mbĕ (đgt) 	Di chuyển. Mbe\ ti anôk mkăn: Di chuyển chỗ khác.
Mbha (đgt) 	1. Chia. Mbha bruă: Chia công việc; Mbha ngăn drăp: Chia tài sản. 
	2. Cấp. Mbha braih: Cấp gạo. Mbha êa drao: Cấp thuốc; Mbha hdruôm hră m’ar: Cấp sách vở.
 	3. Phát. Mbha m’ar bi lông: Phát giấy thi.
Mbhă (tt)	Gặp may
Mbhă mbhai (tt) 	May măn. Mbhă mbhai tuôm ho\ng ih ti anei: Gặp anh ở đây thật may măn. 
Mbhêč (đgt)	Phát sợ.
Mbhĭt mprah (tt)	Bực tức. Hlăm ai tiê mbhyøt mprah: Bực tức trong lòng.
Mbĭt (lt)	Cùng
Mblač (đgt)	Mổ phanh ra.  
Mblah (dt)	Chiến tranh. Eùnuk bi mblah: Thời chiến tranh.
Mblang (đgt) 	1. Dịch thuật. Mblang klei Yuăn kơ klei Êđê: Dịch tiếng Kinh sang tiếng Êđê. 
	2. Giảng (bài). Eùjai nai dôk mblang phung hđeh dôk kriêp: Trong khi cô giáo giảng bài học sinh ngồi im. 
	3. Giải thích. Mblang kơ yûu ]iăng brei yûu thâo săng. Giải thích để cho nó hiểu.
	4. Mở ra. Mblang adu\: Mở dù (ô).
Mblei (mnia) (đgt)	Mua (bán). Ngă bruă mbei mnia: Làm nghề buôn bán.
Mbliah (đgt)	Mổ
Mbliat (đgt)	Mở ra
Mbliư̆ (đgt)	Tráo trở
Mbliư̆ mlih (đgt) 	Đồng hí. Eùnhiang mbliư\ mlih hlăm asei mlei: quôa treãnh đồng hí của cơ thể.
Mbliư̆ wĭt (đgt) 	Phản bội. 
Mbloh (pht)	Chốc
Mbloh ƀiă (dt)	Tí nữa. Mbloh [iă truh yơh di yûu: Tí nữa họ sẽ đến.
Mbluăt (đgt)	Luồn qua.
Mbluôp (đgt)	Nối (hai đầu ống với nhau). Mbluôp đyøng êa krih kphê: Nối ống dây tưới cà phê.
Mblŭ (đgt)	Lên tiếng
Mblŭt (đgt)	Nói quá. 
Mblư̆ (đgt) 	Lật
Mboh (đgt) 	1. Đậu quả (có quả)
	2. Đẻ trứng (động vật đẻ trứng). Mnu\ ana mboh: Gà mái    đẻ trứng.
Mbŏ (đgt) 	Đổ đầy
Mbô (dt) 	Cây sậy. Mbô ]ăt hlăm trăp trang: Cây sậy mọc ở đầm lầy.
Mbông (dt)	1. Xà máng. (Cây tre đục làm thành máng để đỡ phên vách). Mu\t sang gao mbông: Vào nhà sàn bước qua xà máng. 
	2. Máng lợn. Pơ\ng mdhă ngă mbông u\n: đóng ván làm máng lợn. 
	3. Máng nước. Mbông pioh mđu\ êa hjan: Máng nước để hứng nước mưa.
Mbô̆(yao) (đgt)	Đánh băt cá băôûng voi. (voi làm đục nước băt cá).
Mbrim mbram (tt)	Mờ mờ. Tivi dlăng mbrim mbram: Màn heãnh tivi mờ mờ.
Mbruă (đgt)	Giỏi việc
Mbruê (trgt)	Hôm qua. Mbruê adiê hjan: Hôm qua trời mưa. 
Mbrŭ (đgt)	Làm (ruốc) măm. Mbru\ kan: Ruốc cá. 
Mbrư̆ (tt)	Mẩy hạt
Mbuêh (đgt)	Vuốt
Mbuh (đgt)	Đeo vào. Mbuh kông ti kngan: đeo vòng vào tay.
Mbul	I. (tt) làm nũng(nịu). Mbul ho\ng amyø: làm nũng với mẹ.
	Ii.(đgt) giỡn
Mbung (tt)	Bóng líng. 
Mbuôn 	I. (đgt) vun
	II (dt) Luống. Mbuôn djam puăn: Luống rau muống.
Mbuôn kkuh (đgt) 	Quyoå lạy. Mbuôn kkuh kơ anăp rup sang yang: Quyoå lạy trước bàn thờ tổ tiên; Mbuôn kkuh ti anăp ama akâo pap klei soh: Quyoå lạy trước mặt cha xin tha tội.
Mbŭ (đgt) 	Vun xới. Mbu\ phu\n êtak: Vun xới gốc đậu; Mbu\ lăn ksul phu\n: Xới đất vun gốc.
Mbŭk (đgt)	Quậy. (Say rượu quậy). 
Mƀaih (tht)	Eøi. 
Mƀar (đgt) 	Mặc cho (váy). Amyø bi m[ar m’iêng kơ anak: Mẹ mặc váy cho con.
Mƀăt (đgt)	Nêm. M[ăt hra hlăm djam: Nêm canh vừa miệng. 
Mƀâo (đgt)	Cho ngửi
Mƀăng (đgt)	Làm lỗ
Mƀhĭ (đgt)	Nghiền nát. M[hyø kpu\ng: Nghiền nát bột.
Mƀĭn (bi kƀĭn) (đgt)	1. Họp
	2. Cộng lại. 
Mƀĭt (tt)	Còn đầy. Eùsei djam adôk m[yøt: Cơm canh còn đầy. 
Mƀlă (đgt) 	Nuôi
Mƀlăk (đgt)	Nuôi bộ. M[lăk ho\ng êa vi: Nuôi bộ băôûng nước cơm. 
Mƀlăn ală (đgt)	Trợn măt.  
Mƀleng mƀlong (tt) 	Đậy vênh.
Mƀliêt (đgt)	Luồn. M[liêt mmiă mu\t: Luồn chen vào.
Mƀlir (đgt) 	Dán. M[lir anôk tyø: Dán chỗ bị rách. 
Mƀlir kal (đgt)	Niêm phong. M[lir kal klei bi lông: Niêm phong đề thi. 
Mƀlĭt (đgt)	Dán (cho dính). M[lyøt hră: Dán sách.
Mƀlŏng mƀlơt (tt) 	Gồ ghề.
Mƀluăt (đgt)	Luồn qua. 
Mƀluih mƀlơih (tt)	Bơ phờ.
Mƀlum (đgt)	Thuần hí. M[lum êman dliê jing êman [uôn: Thuần hí voi rừng thành voi nhà.
Mƀoh mƀal (tt)	Meôo mó. Krah rup m[oh m[al: Tạc tượng meôo mó. 
Mƀơ̆ng (đgt)	Châm (lửa). M[ơ\ng pui hăt: Châm lửa thuốc.
Mƀroh (dt)	Aoùi
Mƀroh mƀrăt (tt) 	Eøuïm ịm. Đo\k m[roh m[ăt: giọng ồm ịm
Mƀuh (đgt)	Aoûm ảnh.
Mƀuiñ (tt)	Yoù vào. Đăm lo\ m[uiyû kơ amyø ama ôh: đừng có yoã vào bố mẹ.
Mƀŭk (đgt)	Quấn tóc.
Mƀư̆ (đgt)	Uốn thẳng. M[ư\ grăn wăng: Uốn thẳng cán cuốc.
Mčah (đgt) 	Vỡ
Mčah rai (tt) 	Vỡ nát,vỡ tan. {êyû m]ah rai: Bánh vỡ nát. 
Mčai (tt)	Nhiều
Mčaĭ ênai dhuai (đgt)	Loan tin. M]ayø ênai dhuai bo\ [uôn: Loan tin khăp buôn.
Mčeh luar (đgt)	Vu khống
Mčei (tt)	Ngang sức
Mčhet mčhot (tt)	Vớ vẩn.
Mčhi 	Không dám. Kâo amâo m]hi: Tôi không dám.
Mčhĭ (đgt)	Đổ thừa cho ai đó. Đăm lo\ duah m]hyø kơ pô anei pô adih ôh: đừng có đổ thừa cho người này người kia nữa.
Mčhĭ klei soh (đgt)	Đổ tội
Mčhĭn (đgt) 	Chỉ trích.
Mčhŏ (đgt) 	Làm dơ
Mčhô  (dt)	Mõm dài.
Mčhu (kƀông) (đgt)	Chu miệng.  Si lei ih dê m]hu he\ k[ông mơh: Làm geã mà chu cái miệng.
Mčhuai (tt)	Nhầm lón. Khăng m]huai nanao dua ayo\ng adei di yûu: Hai anh em nó hay bị nhầm lón. 
Mčhuk ai (tt)	Nức lòng. 
Mčhum (đgt)	Chịng (hông). {ă e\ m]hum he\ jơ\ng: địu beô phải chịng chân.
Mčhur (đgt)	Xui
Mčhŭ (đgt)	Lón
Mčhưr (đgt)	Xuyên tạc
Mčiêm (đgt)	Cho ăn. M]iêm e\ [ơ\ng bur: Cho beô ăn cháo. 
Mčiêng (tt) 	Nghiêng. Đih m]iêng: Năôûm nghiêng. 
Mčuê (đgt)	Nối. M]uê anôk tloh: Nối dây chỗ bị đứt.
Mčuit (tt)	Cheôo. {ôyû m]uit: đan cheôo.
Mčuit mčuat (tt)	Xoăn xuyôt. Hrue# m]uit m]uat: Dây leo xoăn xuyôt.
Mčuôp (bi kčuôp) (dt)	Tảo hôn. Klei bhiăn m]uôp ung mo#: Tục tảo hôn.
Mda (tt) 	1. Non. Chuối non: Mtei mda. 
	2. Trẻ. Adôk mda ka truh thu\n hlăk ai: Còn trẻ chưa đến tuổi thành niên.
Mdah (đgt) 	1. Chiếu. Mdah rup: Chiếu phim. 
	2. Bày tỏ. Mdah klei ênguôt hnyøng pô: Bày tỏ nỗi niềm của meãnh.
	3. Phô ra
Mdah klei blŭ (đgt)	Phát biểu. Mdah klei blu\ ti anăp mnuih lu: Phát biểu trước đám đông. 
Mdan (đgt)	Đặt ngồi. 
Mdang (đgt)	Sưởi (ấm). Dôk mdang pui: Ngồi sưởi ấm.
Mdar (đgt) 	Cho quay
Mdăk mduê (tt)	Cầu kyoå. Prue# blu\ mdăk mduê: Câu văn cầu kyoå. 
Mdăp (đgt) 	Giấu giếm
Mdeh (trt)	Nheô.
Mdei (đgt)	Nghỉ. Mdei bruă: Nghỉ việc.
Mdei bhiâo (đgt)	Nghỉ giải lao
Mdei msăn (đgt)	Nghỉ ngơi. Mă bruă amâo mdei msăn: Làm việc không nghỉ ngơi. 
Mdei prŏng (đgt) 	Nghỉ hè. Phung hđeh hriăm hră mdei pro\ng: Học sinh nghỉ hè.
Mdê (mdhê) (tt)	Khác. Mdê klei blu\: Khác ngôn ngữ. 
Mdê gah gôk(tt)	Khác lạ. Dlăng kơ yûu mdê gah gôk: Trông nó khác lạ.
Mdê mdô (tt)	Bất đồng. Mdê mdô klei blu\: Bất đồng ngôn ngữ. 
Mdê̆č (đgt)	Tránh
Mdê̆č mdar (tt)	1. Quanh co. Blu\ mde#] mdar amâo jho\ng la] kpă ôh: Không dám nói thật mà cứ nói quanh co.
	2. Tráo trở
Mdhă (dt)	Ván. Mdhă lat: Ván eôp. 
Mdhung mdhiang (tt)	Rề rà
Mdhô̆(mdô̆) (dt)	Cái ghế. Dôk gu\ ti mdho#: Ngồi xuống ghế.
Mdhŭr (dt) 	Mdhu\r (một nhánh người Êđê). 
Mdhư̆ (tt)	Ngào ngạt. Mnâo êa klôyû mdhư\: Mùi hương nước hoa ngào ngạt.
Mdian (đgt)	Aoùo thuật. Nao dlăng arăng ngă mdian: đi xem ảo thuật.
Mdiăng (đgt) 	Chở. 
Mdiê (dt) 	Luôa. Nao pla mdiê: đi cấy luôa; Mdiê đio\: Luôa nếp; Mdiê hdrô: Luôa râu; Mdiê mjeh: Luôa giống.
Mdiê kuê (dt)	Luôa gạo. Mnuih [uôn sang mâo lu Mdiê kuê: Dân làng có nhiều luôa gạo. 
Mdiêr (tt)	Vòng vo. Blu\ mdiêr: Nói vòng vo. 
Mdih	I. (trgt) hôm kia. Mdih ti ih nao? : hôm kia anh đi đâu?.
	Ii. (đgt) thức giấc. Đăm blu\ ktang ôh leh e\ mdih: đừng nói to kẻo beô thức giấc.   
Mdih pĭt (đgt)	Thức dậy
Mding mdoang (tt)	Chíng váng. Ko\ asei mding mdoang: đầu bị chíng váng. 
Mdiông (đgt) 	Giao phối (con chó).
Mdit mduôt (tt)	Lỉnh kỉnh. Mnơ\ng mnuă mdit mduôt: đồ đạc lỉnh kỉnh. 
Mdĭ mdĭn (tt)	Dồn dập. Bruă mdyø mdyøn: Công việc dồn dập. 
Mdĭng mdŏng (tt) 	Tòng teng.
Mdjah (đgt)	Chấm vào. Mdjah êa drao anôk êka: Chấm thuốc vào vết thương.
Mdjah mdjik (tt) 	Bậy bạ
Mdjăp (đgt)	Làm đủ
Mdjâo (đgt)	Duô chín. Mdjâo boh [ơr: Duô quả bơ. 
Mdjĕ (tt)	Làm nhẹ
Mdjiê (đgt)	Giết. Mdjiê mnuih: Giết người;  Mdjiê êmô: Giết bò.
Mdjiêô (đgt)	Để một bên.
Mdjik (đgt)	Gheôp đôi. Đăm lo\ mdjik yûu ôh: đừng có gheôp đôi nó nữa. 
Mdjip mdjap (tt)	Què quặt. Asei mlei mdjip mdjap: Thân heãnh què quặt.
Mdjoh (đgt)	Làm nũng(nịu). Grăp bliư\ ]iêm e\ huă mdjoh nanao: Mỗi lần cho beô ăn cơm luôc nào cũng làm nũng. 
Mdjŏ (đgt)	1. Đối chiếu. Lo\ bi mdjo\: đối chiếu lại.
	2. Làm truông. 
Mdjuê (đgt)	Để giống
Mdlưh (đgt)	1. Lật đổ. Mdlưh knu\k kna mtao mtu\ng: Lật đổ chế độ phong kiến.
	2. Hạ xuống. Mdlưh adu\ jih hjan leh: Hạ dù xuống hết mưa rồi; Mdlưh mu\ng: Buông màn. 
Mdlưh rai (đgt)	Lật đổ
Mdoh (đgt)  	Vệ sinh
Mdŏng (dt) 	Tên của một lịi chim.  
Mdô̆(dt)	Cái ghế. Dôk gu\ ti mdo# : Ngồi ghế; Mdo# knang: Ghế dựa.
Mdơ̆k (dt) 	Cây môn thục. Mdơ\k êbua ]ăt hlăm trăp trang: Cây môn thục mọc ở đầm lầy.
Mdơ̆k m’ơr (tt)	Rùm beng.  
Mdơ̆ng (đgt) 	1. Dựng lên. Mdơ\ng kmeh sang: Dựng cột nhà. 
	2. Cất. Mdơ\ng sang: Cất nhà.
	3. Dọn. Mdơ\ng êsei kơ tuê: Dọn cơm cho khách.
Mdơ̆ng brei ruah (đgt)	Đề cử. Mnuih arăng mdơ\ng brei ruah: người được đề cử. 
Mdrao (đgt)	Chữa. Mdrao klei ruă : Chữa bệnh. 
Mdrao mgŭn (dt)	Y tế. 
Mdriâo (đgt) 	Reo hò.
Mdriêng(djiê) (dt) 	Chết tai nạn.
Mdrŏng (tt)	Giàu. Sang mdro\ng: Nhà giàu; Ala ]ar mdro\ng mnuih [uôn sang ktang kjăp: Dân giàu nước mạnh.
Mdrŏng sah (tt)	Giàu sang. 
Mdrung (tt)	Nghiêng. Boh hră mdrung: Chữ viết nghiêng.
Mdu (đgt)	Giảm nhẹ
Mdua (dt) 	Đôi. Mbha mdua: chia đôi.
Mdua mdua (dt)	Từng cặp. Hlăp mdua mdua: Chơi từng cặp. 
Mduê (đgt)	Nối.(hai đầu với nhau). Mduê đyøng êa: Nối ống nước.
Mdul (dt)	Đỡ. {ơ\ng ktơr mdul êsei: aûn băp đỡ cơm.
Mduôn (tt)	Già. Phung mduôn êbat djă giê dra. Người già đi chống gậy. 
Mduôn khua (tt) 	Già cả. Amyø ama mduôn khua leh s’ayø: Bố mẹ đã già cả rồi.
Mdŭm (tt)	Băôûng nhau (so sánh ). Mdu\m thu\n: Băôûng (cùng) tuổi.
Mdưh (đgt)	Đặt xuống (dạng cây
Mdưm (đgt)	Đặt (săôïn). Mdưm klei ]ang hmang kơ ênuk hlăk ai: đặt hy vọng vào lớp trẻ; mdưm klei ]uăn: đặt điều kiện.
Mđai (đgt)	Đẻ (con vật
Mđam (đgt)	1. Muối (dưa). Mđam brei msăm: Muối chua.
	2. Ngâm. 
Mđang (đgt)	Lật ngửa
Mđao (tt)	Aõaúm. Ao mđao: aoûo ấm. 
Mđao khŭ (tt)	Aõaúm áp. Adiê mđao khu\: trời ấm áp.
Mđaŏ (đgt)	1. Đố. Mđao\ hlăp: đố vui. 
	2. Thuần dưỡng. Mđao\ êman: Thuần dưỡng voi.
Mđar (đgt)	Đôn đốc
Mđat (đgt)	Chườm. Mđat êa hlơr ti dlông tian: Chườm nước nóng lên bụng.
Mđet mđok (đgt)	Eõỡn ẹo. Eùbat mđet mđot: đi ưỡn ẹo.
Mđê̆č (đgt) 	1. Dệt hoa văn.
	2. Amâo mđe#] : không ăn thua.
Mđhih mđhuaih (tt)	Yểu điệu. Knhuah êbat mđhih mđhuaih: Dáng đi yểu điệu.
Mđhuk (đgt)	Nuông chiều.  Amyø mđhuk anak măk: Mẹ chiều con hư.
Mđiă (tt)	Năng. Adiê mđiă yơ yăng: Trời năng chang chang. 
Mđiă ăm (tt)	Nóng hầm. Adiê mđiă ăm: Trời nóng hầm. 
Mđiâo (tt) 	(Người thuận tay) trái.
Mđiâo mang (tt) 	Xem không ra geã. Dlăng kơ kâo mđiâo mang: Xem tôi chẳng ra geã.
Mđiăl (đgt)	Chọc ghẹo
Mđiêô (đgt)	Đưa leôn. Mđiêô ]yøm ba wyøt kơ sang: đưa leôn thịt mang về nhà.
Mđih (đgt) 	Đặt cho năôûm. Mđih e\ ti jao: đặt beô năôûm võng.
Mđing hmư̆ (đgt)	Lăng nghe. Mđing hmư\ klei nai mtô mblang: Lăng nghe cô giáo giảng bài.
Mđing thao (đgt)	Nghiêng chậu. Mđing thao mđu\ êa: Nghiêng chậu hứng nước.
Mđĭ (đgt)	Nâng. Mđyø ti dlông: Nâng lên trên. 
Mđĭ  kdlưn (đgt)	Nâng lên. 
Mđĭ mđal (tt)	Chập chùng. }ư\ ]hiăng mđyø mđal: đồi nuôi chập chùng. 
Mđoh (đgt)	1. Keôo (gỗ). Eùman mđoh kyâo: Voi keôo gỗ.
	2. Đón (nước). Mđoh êa ba hlăm lo\: Đón nước vô ruộng. 
Mđŏk (tt)	Đanh đá. Mniê anăn mđo\k êdi: cô ta đanh đá thật.
Mđơr (tt)	Băôûng nhau (so sánh bề ngang). Di yûu dua mđơr: Hai đứa băôûng nhau. Mđơr dơ\ng mgăn: Ngang dọc băôûng nhau.
Mđơt (tt)	Cộc (quần
Mđuê̆ (đgt) 	Di dời.
Mđrăk mđrê (tt) 	Rộn ràng. Ryøng rai myûê mđrăk mđrê: Ve kêu rộn ràng.
Mđrăm	1. (pt) đồng thanh. Jih jang adu\ dlăng mđrăm: Cả lớp đọc đồng thanh. 
	2. (trt) Cùng. Nao mbyøt wyøt mđrăm: đi chung về cùng.
Mđrăm mbĭt (tt)	Nhịp nhàng. Hgu\m ai mđrăm mbyøt: Phối hợp nhịp nhàng; Jơ\ng ]huang mđrăm mbyøt tui hlue ênai hgơr: Chân bước nhịp nhàng theo tiếng trống.
Mđring mđrông (tt)	Dăôûng dặc. Dlông mđring mđrông: Dài dăôûng dặc.
Mđrĭng mđrĭng (tt) 	Song song. Eùbat mđryøng mđryøng: Bước song song. 
Mđrông (tt) 	Khuôc dài. Kbâo lui mđrông: Mía để từng khuôc dài. 
Mđruê̆ mđrông (đgt) 	Nối đuôi nhau
Mđua (đgt)	Đội (cho). Adiê mđiă mđua đuôn kơ adei: trời năng đội mũ cho em; mđua đuôn mtao: đội vương miện.
Mđung (tt) 	Rực rỡ. Mnga blang mđung: Hoa nở rực rỡ. 
Mđung asăp (đgt)	Phát thanh. 
Mđung hla (đgt)	Thả diều. Phung hđeh mđung hla: Bọn trẻ thả diều. 
Mđung mdiê (đgt)	Rê luôa. 
Mđup (đgt)	Đưa (lên). 
Mđup myơr (đgt)	Dâng
Mđur (đgt)	Mua chuộc. Aáu anăn leh phung jhat bi mđur: Anh ấy bị bọn xấu mua chuộc.
Mđŭ (đgt)	Hứng. Mđu\ êa hjan: Hứng nước mưa.
Mđŭk mđŭl (tt)	Uể oải. Hlăm asei mlei mđu\k mđu\l: Trong người cảm thấy uể oải.  
Mđưh ai (đgt) 	Chọc tức. Mđưh ai yûu: Chọc tức nó.  
Mđưn (tt)	Huênh hoang
Mgaih (đgt)	Dọn sạch. Riêng gah sang mgaih doh bhung: Xung quanh nhà dọn sạch sạch sẽ. 
Mgam (đgt) 	Tiếp
Mgang (đgt)	1. Phòng. Mgang klei ruă kơ mnu\ da: Phòng bệnh cho gà. 
	2. Bảo thủ. La] kơ yûu mgang êdi: Nó rất bảo thủ. 
	3. Bảo vệ. Mgang [uôn sang: Bảo vệ [uôn làng; Mgang kmrơ\ng dhông: Bảo vệ rừng; Mgang lăn ]ar: Bảo vệ Tổ quốc.
Mgao (đgt)	Quôa trớn
Mgap (tt)	May măn.  (Dùng cho người đi săn).
Mgar (dt)	Lòng chảo. }ư\ Mgar (Tên của một địa danh).
Mgăk mgưi (tt) 	Ngất ngưởng. Mkăm mgăk mgưi: Chất đống ngất ngưởng. 
Mgăl (đgt)	Cãi lại. Mgăl [rưk [rưk ho\ng amyø ama: Cãi ra rả với cha mẹ.
Mgăm (dt)	Chim gầm gheã. Mgăm [ơ\ng boh mnu\t: Chim gầm gheã ăn quả đa. 
Mgăn (đgt)	Ngang. 
Mgăt (dt) 	Người chăn dăt. Mgăt êmô: Người chăn bò.   
Mgăt êdeh (dt)	Tài xế.
Mgei (đgt)	Rung
Mgê̆č (tt)	Tinh. Miêô ală mge#]: Măt mèo tinh.
Mghă (đgt)	Đỡ. Aáu ]ăm kâo
Mghăm (tt)	Rầm (tiếng đổ). Kyâo joh mghăm: Cây đổ rầm.
Mghăp (đgt)	Chớp lấy thời cơ
Mghŭm mghăm (tt) 	Rầm rầm. Kyâo joh mghu\m mghăm:  Cây đổ rầm rầm. 
Mgi (trgt)	Ngày mai. Mgi jing hruê kjuh: Ngày mai là ngày chủ nhật; Mgi kơ mgi: Ngày mai rồi lại ngày mai.
Mgi aguah dih (dt) 	Nay mai. Mgi aguah dih tơ dah wăn hriê ]hưn ho\!: Nay mai nếu rảnh đến chơi nheô !
Mgiăm (đgt)	Xê lại gần. 
Mgoh (đgt)	Trau chuốt
Mgô (đgt)	Làm cong.  
Mgô̆(đgt)	Eoûp. Kpyø prayø kpyø êmă
Mgô̆hrŭn (đgt) 	Bó buộc.  
Mgô̆m’an (đgt)	Eoûp buộc
Mgơ̆ng (đt)	Đặt
Mgơ̆ng brei ruah (đgt)	Eõoûng cử. Mnuih mgơ\ng brei ruah: người được ứng cử.
Mgrăn (đgt)	Làm cán. Mgrăn dho\ng: Làm cán dao. 
Mgrăng (đgt)	Hị giải. Mgrăng ho\ng klei găl
Mgrông (đgt)	Aoûp tải. 
Mgu (tt)	Ngốc. Mgu đei
Mguăt mguê (tt)	Ngoăôûn ngoèo. Eùlan nao kơ hma mguăt mguê: đường đi róy ngoăôûn ngoèo.
Mguôp (đgt)	1. Góp. Mguôp prăk blei êdeh: Góp tiền mua xe.
	2. Kết hợp. Mtô mjuăt mguôp plah wah sang hră ho\ng amyø ama: Giáo dục kết hợp giữa nhà trường và gia đeãnh.
	3. Kết đôi. Mguôp di yûu dua jing ung mo#: Kết đôi hai đứa thành vợ thành chồng.
Mgur (dt) 	Chim trĩ.
Mgưt (đgt)	Giả vờ
Mhač	I. (tt) cởi mở
	Ii. (đgt) nói thầm. 
Mhač čhač (tt)	Niềm nở. Di yûu drông hmei ho\ng ai tiê mha] ]ha]: Họ đón tiếp chuông tôi với tấm lòng niềm nở.
Mhai (đgt)	Tràn ra. Braih ho\k mhai: Gạo đổ tràn ra.
Mhang (đgt) 	Hơ (lửa). Mhang ao brei thu: Hơ áo cho khô.
Mhao (đgt)	1.Thèm. Mhao boh msăm: Thèm chua. 
	2. Khát. Mhao êa: Khát nước.
Mhăk mhai (tt)	Xởi lởi
Mhăm (tt)	Rầm.  Hmư\ ênai joh mhăm: Nghe tiếng đổ rầm.
Mhâo (dt)	Ngực.
Mhêñ (đgt)	Dứ (nhử). Mhêyû [êyû kơ hđeh: Dứ kẹo trẻ con. 
Mhêñ mhu (đgt)	Ngấp ngheô. Phung kne\ mhêyû mhu duah dlăng: Kẻ trộm ngấp ngheô dòm ngó.
Mhê̆č mhăr (tt)	1. Tinh ranh. Mhe#] mhăr si mja: Tinh ranh như cáo. 
	2. Minh món. Khă mduôn he\ [iă dah ko\ dlô adôk mhe#] mhăr: Tuy già nhưng đầu óc vón còn minh món.
	3. Mưu trí. Yua klei mhe#] mhăr mblah roh: Dùng mưu trí đánh giặc.
Mhiâo (đgt)	Quát
Mhing (đgt)	Chất đống. Mkăm djuh mhing: Chất đống củi. 
Mhip mhap (tt)	Bê bết. }hum ao mhip mhap ]ho\ lăn: Quần áo bê bết bùn đất. 
Mhrĭng mhrăm (tt)	Nhăn nhó. {o# mta mhryøm mhrăm ]iăng ăl nao ruôp. Mặt mày luôc nào cũng nhăn nhó. 
Mhrŏ (đgt)	Giảm.  Mhro\ klei ư\ êpa [un knap: Xí đói giảm nghèo.
Mhua (tt) 	Dài thườn thượt.
Mhui mhai (tt)	Chan hị. Kdrăn lo\ mhui mhai mđiă: Cánh đồng chan hị ánh năng.
Mhuĭ (đgt)	Doạ. Mhuyø hđeh: Doạ trẻ con.
Mhung mhing (tt)	Cả đống
Mhuôl (đgt)	Xông hơi. Mhuôl hla plăng ]iăng kơ hlao hdrak: Xông hơi băôûng lá sả đỡ cảm cuôm.
Mhưk (tt)	Rực. Pui [ơ\ng mhưk: Lửa cháy rực. 
Mhưng (đgt)	Hơ. Mhưng jơ\ng ]iăng kơ mđao: Hơ chân cho ấm. 
Mhưp (đgt)	Dứ (nhử). Mhưp keo\ kơ hđeh: Dứ kẹo trẻ con. 
Mia (đgt) 	1. Bôi. Mia êa ju\ bo\ ao: Bôi mực đầy áo; Mia êa [âo mngưi: Bôi (xức) nước hoa.
	2. Sơn. Sang mia êa mtah : Nhà sơn màu xanh; Mia ]u\r: Sơn (queôt) vôi. 
M’ia (tt)	Nhão
Miăm miăm (đgt) 	Lẩm bẩm. 
M’iêk (đgt)	Đái. Hđeh điêt m’iêk ram: trẻ con đái dầm. 
Miêng (dt) 	Má. Ke#] ke\ ti miêng: Muỗi chích ngay má.
M’iêng (dt)	Váy. {ar m’iêng: Mặc váy.
Miêu (dt)	Con mèo. Miêu mă kkuih: Con mèo băt chuột.
Mih mưh (tt)	Tò mò.
Mil čhil (dt)	1. Tột cùng
	2. Dân chủ. Klei dưi êngiê
Min (dt)	Meãn. Bi mtuh min: Nổ meãn.
Mĭn (đgt)	Nghĩ. Bi myøn kơ amyø: Nghĩ về mẹ; myøn kơ bruă ka leh dôk amâo h’yøt: Nghĩ công việc chưa xong không yên tâm.  
M’ĭt (đgt)	Gửi. M’yøt prăk kơ anak dôk kbưi: Gửi tiền cho con ở xa.
M’ĭt hră (đgt) 	Gửi thư.
Mja (dt)	Con chồn. Mja lir: Chồn hương.
Mjai (đgt) 	Độn
Mjan (đgt) 	Thuôc giục. Mjan bi mă kan: Giục nhau băt cá.
Mjăm (đgt) 	Che giấu. Mjăm he\ klei soh yûu: Giấu tội của nó.
Mjăm mji (tt) 	Lấp láp.
Mjâo (dt) 	Thầy bói. Nao [u] kơ mjâo: đi xem thầy bói.
Mjâo mtâo (dt) 	Phù thủy. 
Mjeh (dt) 	Hạt giống. Mjeh pioh pla: Hạt giống để trồng.
Mjei (tt) 	Dữ tợn. {o# mta dlăng mjei: Khuôn mặt dữ tợn.
Mjet mjot (tt) 	Eoùo lả.
Mjĕ (đt) 	Đi lại với nhau.
Mjĕ mjing (đgt) 	Kết nghĩa. Mje\ mjing ayo\ng adei: Kết nghĩa anh em.
Mjêč mruăt (đgt) 	Hối thuôc. Nao mje#] mruăt: đi hối thuôc.
Mjhah mjhĭng (tt) 	Luộm thuộm
Mjhĭt m’uôt (tt) 	Thèm thuồng. 
Mjhô (đgt)	Mặc dùm. Mjhô ao kơ e\: Cho beô mặc áo.
Mjhua (đgt)	Lợi dụng. Mjhua klei đao\ brei mnuih [uôn sang ngă soh: Lợi dụng tôn giáo xuôi dân làng làm điều xấu. 
Mjhŭk mjhŭl (tt) 	Rối bù. {u\k biêk mjhu\k mjhu\l: Tóc tai rối bù. 
Mjing (đgt)	1. Tạo ra. Kâo srăng mjing yûu jing sa ]ô mnuih jăk: Tôi sẽ đào tạo nó thành một người tốt.
	2. Làm thành. Kâo srăng mjing sang anei jing sa boh sang  siam: Tôi sẽ làm nhà này thành một ngôi nhà đẹp.
Mjuă (đgt) 	Trả giá. Blei mjuă: Mua trả giá.
Mjuăt (đgt) 	Tập
Mjuih (tt) 	Nghiêm nghị
Mjuk (đgt)	Kết bạn (giữa phụ nữ với nhau).
Mjum (đgt)	Dỗ
Mjut (đgt)	Mới băt đầu nuôi. Mjut rông êmô: Mới băt đầu nuôi bò.
Mjưh (đgt)	Dừng lại. Mjưh êdeh: Dừng xe.
Mkai (dt) 	Dưa hấu. Blah [ơ\ng mkai: Bổ dưa hấu ăn.
Mkao (dt) 	Cuô mèo.
Mkă 	1. (đgt) Cân. Mkă  kyø: Cân kyô. 
	2. (đgt) đo. Mkă boh [ai lăn hma: đo diện tích đất róy.
	3. (tt) So. Kphê sang kâo thu\n anei mboh lu hyøn mkă ho\ng thu\n adih: Cà phê nhà tôi năm nay nhiều trái hơn so với năm trước.
Mkăk mkai (tt) 	Ngổn ngang. Dưm kyâo mkăk mkai ti ta]: để gỗ ngổn ngang ngịi trời.
Mkăm (đgt)	Chất đống. Mkăm djuh mgăk mgưi: Chất đống củi ngổn ngang.
Mkăn (tt) 	Khác. Brei kơ kâo dho\ng mkăn: Cho tôi cái dao khác.
Mkăp (đgt) 	Trang bị. 
Mkăp mgang (đgt) 	Bảo hiểm. Mkăp mgang asei mlei: Bảo hiểm thân thể.
Mkeč mkoč (tt) 	Loăôûng ngoăôûng. Boh hră ]ih mke] mko]: Chữ viết loăôûng ngoăôûng.
Mkeh mkoh (dt)	Sự khác nhau.
Mkĕ (đgt) 	Nối chặt
Mkiêt mkuôm (đgt) 	Tiết kiệm
Mkĭt (dt) 	Luôa râu. (Tên của một giống luôa).
Mkhik mkhak (tt) 	Quê mùa. Knhuah ]u\t h’ô dôk mkhik mkhak: Cách ăn mặc còn hơi quê mùa.
Mkhiăng (tt) 	Neôt mặt dữ dăôûn. 
Mkhĭt mkhŭt (tt) 	Cứng quào quạo.
Mkhơh 	Tư thế đứng như trời trồng.
Mkhuôt (đgt) 	Làm cạn. Mkhuôt êa: Ruôt cạn nước.
Mkhư̆ (đgt)	Cản
Mkhư̆ mgang (đgt) 	Ngăn chặn. Mkhư\ mgang klei ruă tưp: Ngăn chặn bệnh lây lan.
Mklă (đgt)	Làm rõ.
Mklăk (tt) 	Ngược. Yap mklăk: đếm ngược.
Mklin mguôp (đgt) 	Tổng hợp. 
Mklŏ (đgt) 	Nặn thành cục.
Mkŏ (đgt) 	Lăp
Mkra (đgt) 	1. Làm. Mkra sang: Làm nhà. 
	2. Chế biến. Mkra mnơ\ng [ơ\ng huă: Chế biến thức ăn.
	3. Sửa chữa. Mka êdeh wai jơ\ng: Sửa chữa xe đạp.
Mkrah (dt) 	Một nửa. Mbha mkrah: Chia một nửa.
Mkrah dưh (tt) 	Lỡ dở
Mkriâo (đgt) 	Đăôïn xung quanh gốc để cây chết.
Mkruôp (tt) 	Chăôïn
Mkrum (đgt) 	Hùn lại. Bi mkrum prăk: Hùn tiền. 
Mkua (đgt) 	Chất thêm
Mkuê̆ (dt) 	Tấm. Pruê mkue# kơ mnu\: Cho gà ăn tấm.
Mkuôm (đgt) 	Giành dụm. Mkuôm prăk pioh blei êdeh: Dành dụm tiền để mua xe.
Mkŭm mkăm (tt)	Ngổn ngang. Kyâo joh mku\m mkăm bo\ êlan: Cây đổ ngổn ngang đầy đường.
Mkŭp (đgt) 	1. Vập. Le\ buh mku\p [o# ti gu\: Ngã vập mặt xuống. 
	2. Uoûp. Mku\p ]hiên hlăm ê-i. Uoûp cheôn vào rổ.
Mkưh mkăm (dt)	1. Đống. Mkưh mkăm dhan djuh: Củi cả đống. 
	2. Vô vàn. Bruă adôk mkưh mkăm: Vô vàn công việc.
Mla (dt) 	Ngà. Mla êman: Ngà voi; Ksi ngă ho\ng mla êman: Lược làm băôûng ngà voi.
Mlam (dt) 	Đêm. Krah mlam: đêm khuya.
Mlan (dt) 	1. Tháng. Mlan sa: Tháng giêng.
	2. Mặt trăng. Hruê teh hjan mlan teh không: Trăng quầng trời hạn trăng tán trời mưa.  
Mlang (dt) 	Chim bồ chao. 
Mlăk djŏ (tt)	Truông phóc. Mnah hlô mlăk djo\ ti ai: Băn thuô truông phóc ngay huyệt. 
Mlăng (dt) 	Rau mồng tơi. Pla djam mlăng: Trồng rau mồng tơi.
Mlăp (tt) 	Truông phập. 
Mlâo (dt) 	Lông. Mlâo ală: Lông mày. 
Mlâo muñ kang (dt) 	Râu căôûm. 
Mlei (tt)	Phạm thiêng
Mlê (tt)	Ngồi thư thái. Dôk gu\ mlê ti mdo#: Ngồi thư thái trên ghế.
Mlhuê̆č (tt) 	Ngộ nghĩnh. Hđeh điêt anăn mlhue#]: Em beô ấy rất ngộ nghĩnh. 
Mli (mni) (đgt) 	Khen. 
Mliat (đgt)	Trải ra. Mliat ayûuê ti krah sang: Trải chiếu giữa sàn nhà.
Mlih (đgt) 	Đổi chác. Nao mlih djuh kơ djam: đi đổi củi lấy rau. 
Mliêo (dt)	{uôn Mliêo.
Mliêt (tt)	1. Tiệt
	2. Ráo. Nao êku\t jih mliêt: đi văng ráo cả.
Mlim (đgt)	Ngậm. Mlim [êyû keo\: Ngậm kẹo.
Mlĭng (dt) 	Chim chèo bẻo.
Mloh mlăp (tt) 	Hấp tấp. Mă bruă mloh mlăp: Làm việc hấp tấp.
Mlŏ (dt) 	Cái lọ đựng dế (làm băôûng bầu khô nhỏ căt miệng). Djă mlo\ lir nao [e#] [ưi: đem lọ đựng dế đi bóy chim.
Mlơ̆ng (tt) 	Hài hước. Mlơ\ng êdi mniê anăn: Cô ta thật là hài hước.
Mlô (dt) 	Họ Mlô (người Êđê). 
Mluê (dt)	Bầu khô. (Qủa bầu khô loại to khoeôt miệng dùng để đựng gạo).
Mluĭ (tt) 	No căng. 
Mluk(tt) 	Ngu
Mluk mgu (tt) 	Ngu dốt. Mluk mgu tơl sa boh hră kăn thâo: Ngu dốt đến nỗi một chữ cũng không biết.
Mlum (dt) 	Lang ben. {o# mlum: Mặt lang beng. 
Mlŭn mtah (tt) 	Trần truồng. Dôk mlu\n mtah: eûoù trần truồng.
Mlur mpŭ (tt) 	Nịnh bợ. Thâo mlur mpu\ êdi lah yûu: Anh ta giỏi nịnh bợ. 
Mlưm (đgt) 	Chạm mặt. 
Mlưt (dt) 	Phao câu (nổi lên mặt nước). 
Mmač (tt) 	Quan tâm. Mma] êdi kâo dlăng kơ ih: Tôi thấy anh (nó) tội quá
Mmah (đgt) 	Nhai. Mmah lik: Nhai kyoä; Mmah keo\ kru\p kru\p: Nhai kẹo rào rạo.
Mmai (đgt) 	Nặn.  Mmai lăn ngă boh [i: Nặn đất làm hòn bi.
Mmao (dt) 	Nấm. Mmao adrăng: Nấm rơm; Mmao [lê: Nấm hương; Mmao djhưk: Nấm mèo; Mmao kmrăm: Nấm mối. 
Mmă (đgt)	So sánh.
Mmăt (dt) 	Tối. Di yûu wyøt hma tơl mmăt: Họ về róy đến tối.
Mmăt tĭt (dt) 	Tối mịt. Mlam hjan adiê mmăt tyøt: đêm mưa trời tối mịt.
Mmăt mlam (dt) 	Ban đêm. Hiu hlăp wyøt mmăt mlam: đi chơi về đêm.
Mmiă (đgt) 	Giành. Mmiă do\ adei hlăp: Giành đồ chơi của em; Kdơ\ng mblah ]iăng mmiă wyøt klei êngiê: Kháng chiến để giành độc lập.
Mmih (tt) 	Ngọt. Mmih mse\ si [êyû hra: Ngọt như đường. 
Mmih ƀluč (tt) 	Ngọt lịm. Boh sâo riêng [ơ\ng mmlih [lu]: Qủa sầu riêng ăn ngọt lịm.
Mmĭm (tt) 	Chứa (cán
Mmông (dt) 	Đồng hồ. Mmông kă kngan: đồng hồ đeo tay.
Mmông anei (trgt)	Giờ này
Mmông mtei (dt)	Băp chuối. Reh mmông mtei: Thái băp chuối. 
Mmơr (tt) 	Nhột. Ma] mnu\ rui hlăm asei mmơr êdi: Bọ mạt bò lên người rất nhột.
Mmuiñ (đgt) 	Hát. Mniê anăn mâo đo\k mmuiyû jăk: Cô ấy có giọng hát hay. 
Mmuôn (đgt) 	Nặn. Mmuôn rup kơ hđeh hlăp: Nặn tượng (heãnh) cho trẻ em chơi. 
Mmŭk mmăk (đgt) 	Dứ đầu.
Mmŭt (đgt) 	Nheôt vào.
Mnah (đgt) 	Băn. Mnah phao: Băn suông; Mnah ]yøm: Băn chim; Kliêng mnah : Ngăm băn.
Mnal (dt) 	Vải. Mnal k]oh ]hum ao: Vải may quần áo.
Mnal lăm (dt) 	Giẻ lau.   
Mnang (dt) 	Cau. Boh mnang: Qủa cau. 
Mnă (dt) 	Tù nhân. War mnă: Nhà tù.  
Mnăn (tt)	No.                                                         
Mnăm (đgt) 	Uống. Mnăm êa hdơr kơ hnoh: Uống nước nhớ nguồn.       
Mnâo (dt) 	Mùi. Mnâo đeh kphê mdhư\ dhưr: Mùi rang cà phê nồng nặc; Mnâo [âo bru\: Mùi hôi thối. 
Mnâo mnañ (dt) 	Mùi vị. Tu\k djam hlo\ng amâo mâo mnâo mnayû: Nấu canh không có mùi vị. 
Mneh	1. (dt) Dượng. (tức ama  aneh gọi gọn). 
	2. (đgt) Mneh msao: Cãi nhau.
Mnei (đgt)	Tăm. Bi mnei adei: Tăm cho em; Mnei êa ksyø: Tăm biển. 
Mnê̆č (dt)	Mưu
Mnê̆č blah wang (dt)	Chiến lược (mưu lược chiến tranh).
Mnê̆č hgăm (dt)	Aõm mưu. Mne#] hgăm tăm êdah: aõm mưu bị bại lộ.
Mnêñ (tt) 	Tinh nghịch. Hđeh mne#YÛ: Trẻ tinh nghịch.
Mnga (dt) 	Hoa. Mnga krih: Hoa sen; Pe\ mnga: Hái hoa; Siam mse\ si mnga: đẹp như hoa. 
Mngač (tt) 	Sáng. Adiê Mnga]: Trời sáng; Pui mtrang mnga]: đèn chiếu sáng. 
Mngač bhung (tt) 	Sáng trưng. Pui kmlă mnga] bhung: đèn điện sáng trưng. 
Mngač tač (tt) 	Sáng sủa. Pưk sang mnga] ta]: Nhà cửa sáng sủa. 
Mngah (dt) 	Linh hồn.
Mngal (đgt) 	Trêu ghẹo. Mngal phung hđeh mniê: Trêu ghẹo bạn nữ.
Mngan (dt) 	Cái bát. Hua\ ho\ng mngan: aûn băôûng bát; Mngan djam: Bát canh.
Mngăt (tt) 	Đuối (sức). Djiê mngăt hlăm êa: chết đuối dưới nước.
Mngăt êwa (dt) 	Linh hồn.
Mngưi (tt)	Thơm (mùi). K[u [âo mngưi: Xà phòng thơm. 
Mngưi mngăk (tt)	Thơm lừng.
Mngưñ (đgt) 	Dứ (Làm cho thèm thuồng). Mngưyû [êyû kơ hđeh: Dứ kẹo cho trẻ. 
Mnhar (dt) 	Người ba na.
Mnhat (dt) 	Dùi đục. 
Mnhit mprah (tt) 	Bực bội. Ai tiê Mnhit mprah: Trong lòng bực bội.
Mnhông (tt)	Băôûng (theo chiều dài). Khăt mnhông ho\ng giê dưh: Căt băôûng chiếc đũa.
Mni (đgt)	Khen
Mni m’uăn (đgt)	Khen ngợi. 
Mnia (đgt)	Bán. Nao ]hyø mnia: đi buôn bán. 
Mniă (dt) 	Cái liềm. Wiă mdiê ho\ng mniă: Gặt luôa băôûng liềm.
Mniê (dt) 	Con gái. Kkiêng sa ]ô anak mniê: Sinh một đứa con gái. 
Mnik (bi nik) (đgt)	Làm rõ. Thâo yûu amâo jing nao he
Mnĭ nei (trgt)	Bấy lâu nay. 
Mnĭt (dt)	Phuôt. Sa mmông mâo năm pluh mnyøt: Một giờ có sáu mươi phuôt. 
Mnoh (dt)	Dùi chiêng
Mnông (dt) 	Người mnông. 
Mnơ̆ng (dt) 	Đồ đạc
Mnơ̆ng ƀơ̆ng huă (dt) 	Thực phẩm.
Mnơ̆ng pah mưn (dt)	Phần thưởng. Mnơ\ng pah mưn kơ anak hriăm thâo: Phần thưởng cho con học giỏi.
Mnơ̆ng rông (dt) 	Vật nuôi. Sang rông lu mnơ\ng rông: Nhà nuôi nhiều vật nuôi. 
Mnuai (tt) 	Tương tự.
Mnuh (đgt) 	Huôc. Eùmô mnuh asâo: Bò huôc con chó.
Mnuih (dt) 	Người. Sang lu mnuih: Nhà rất đông người; Mnuih bi ala: Người đại diện. 
Mnuih ƀuôn sang (dt)	Dân làng
Mnuk (bi ênuk)	Cùng một thời điểm. Arăng kkiêng di yûu dua mnuk: Hai đứa sinh cùng lứa tuổi.  
Mnuôr (dt) 	Cống
Mnŭ (dt) 	Con gà. Mnu\ da: Gà queô; Mnu\ dliê: Gà rừng; Mnu\ gôk: Gà lôi; Mnu\ kdjo#: Gà gáy; Mnu\ ngiêk: Gà ri.
Mnŭng (dt) 	Lạt. }ar mnu\ng: Chẻ lạt. 
Mnŭt (ana mnŭt) (dt) 	Cây đa. Ana mnu\t ko\ êa: Cây đa đầu làng.
Mnưh (dt) 	Cái quạt thờ (để trên năp áo quan người chết).
Mnư̆ (dt)	Hàng rào. Koh kram ngă mnư\ Chặt tre làm hàng rào.
Mñak (tt) 	Nhờn (dầu mỡ).
Mñam (đgt) 	1. Đan. Hwiê pioh yua myûam bu\ng: Dây mây dùng để đan gùi. 
	2. Dệt. Phung mniê Êđê khăng pơ\k myûam pin ao: Người phụ nữ Êđê thường dệt thổ cẩm.
Mñah (đgt) 	Loại ra
Mñao (đgt) 	Vò. Myûao djam djă tu\k djam: Vò rau ngót nấu canh.  
Mñă (đgt) 	Gặng
Mñă đŏk (đgt)	Nhấn giọng.
Mñăk mñê (tt) 	Kyoä càng. Mtă myûăk myûê: Dặn kyoä càng.
Mñăl (tt) 	Leã lợm.
Mñĕ (đgt) 	Chuồn
Mñê (đgt) 	1. Kêu
	2. Hót. Nao hlăm kmrơ\ng hmư\ ênai ]yøm myûê mak m’ưr: Vào rừng nghe tiếng chim hót rộn ràng.
Mñê̆č mñao (đgt)	Vò nát. 
Mñir (đgt) 	Dụi. Myûir ală: Dụi măt.
Mñoh (đgt) 	Đụng (tay).
Mñơr (đgt) 	Ngíy. Myûơr [ăng knga: Ngíy lỗ tai.
Mñŭng mñĭng (tt)	Vương vấn. 
Mñŭt (đgt) 	Xô đẩy.
Moh măp (tt)	Cẩu thả. Moh măp đei bi ho\k jih êa ju\: Cẩu thả quá làm đổ hết mực.
Mŏng mit (dt) 	Con đom đóm. Mo\ng mit phiơr hiu êjai mlam: đom đóm bay luôc ban đêm.
M’ô (dt) 	Cây lồ ô. Koh m’ô pioh myûam ê-i: Chặt lồ ô để đan rổ. 
Môk (đgt) 	Tọng. Môk bo\ [ăng êgei: Tọng đầy mồm.
Mô̆(dt) 	Vợ. Găl mo# guôp ung sa] êa krông ăt khuôt mơh: Thuận vợ thuận chồng tát biển đông cũng cạn.
Mơ mơp (tt) 	Sững sờ.
Mơh (trt)	Chứ (để trả lời): Mâo mơh: Có chứ !
Mơh hĕ (trt)	Không (dùng để hỏi). Ih nao mă bruă mơh he\: Anh có đi làm không?
Mơp mơp (tt)	Mòn mỏi. Mơp mơp dôk guôn ama wyøt kơ sang: Chờ bố về nhà mòn mỏi.
Mơ̆ (tht)	Không (tương tự như mơh he\). Ih nao mơ\: Anh có đi không.
Mơ̆ng (lt)	Từ. Nao mơ\ng sang truh kơ anôk mă bruă năng ai 5km: đi từ nhà đến chỗ làm việc khoảng 5km.
Mơ̆ng knuê	Nãy giờ
Mpă	Chia làm bốn. }iă boh krue# mbha mpă: Căt trái cam chia làm bốn. 
Mphơh (đgt)	Vểnh tai.
Mphŭn (dt)	Băt đầu
Mphŭñ (tt) 	Beôo tròn.
Mplĕ (đgt) 	Thả. Mple\ [om: Thả [om; Pe\ boh ksă mple\ hlăm kdhô: Hái trái chín thả vào giỏ. 
Mpliê (đgt) 	Bừa
Mplư (đgt) 	1. Lừa bịp
	2. Nhử mồi. Mplư mnơ\ng kơ kan: Nhử mồi cho cá.
Mpoh (đgt) 	Dập đụng phải.
Mpơt (tt) 	Hói (trán).
Mprăp (đgt)	Săm sửa
Mpruh mprăng (đgt)	Quấy rối. Aáu hriê mpruh mprăng êjai mmông phung hmei dôk huă [ơ\ng: Hăn đến quấy rối trong luôc chuông tôi đang ăn cơm. 
Mpŭ (tt)	Kính trọng. Brei drei thâo mpu\ he\ kơ mnuih mduôn khua: Chuông ta phải biết kính trọng người già cả.
Mpŭ mni (tt)	Tôn vinh. Mnuih knhâo lu mnuih mpu\ mni: Người giỏi được nhiều người tôn vinh. 
Mra (dt) 	Vai. Klam klu\ng ti mra: Vác bao trên vai. 
Mrai (dt) 	(Sợi) chỉ. Ao tloh mrai: Aó đứt chỉ; Mrai jhyøt ao: Chỉ may áo.
Mrač (tt)	Hở  (bụng). 
Mran (dt) 	Thuyền bè. Đyø Mran găn êa krông: đi thuyền qua sông. 
Mrap (tt) 	Dơ dáy. {o# mta êa du\ng s’ayø mrap: Mặt mũi dơ dáy. 
Mră (tt) 	1. Cứng cáp
	2. Chăc. Sang anei sui leh [iă dah ăt dôk kjăp mră: Ngôi nhà này lâu lăm rồi mà vón còn chăc.
Mrâo (tt)	Mới. Mrâo blei ao: Mới mua áo.
Mrâo hin (tt) 	Mới đây. Kâo [uh yûu mrâo hin: Tôi thấy nó mới đây; Ao brei kơ yûu mrâo hin [iă dah tyø leh yơh: Aoûo đưa cho nó mới toanh mà đã rách rồi. 
Mrâo mrang (tt) 	Mới mẻ. Mâo klei mrâo mrang leh ka? Có geã mới mẻ chưa. 
Mring (bi ring) (đgt)	Luân phiên
Mrip mrap (tt) 	Nhớp nhuôa. 
Mrĭm (tt) 	Giận dữ. {o# mta mryøm: Khuôn mặt giận dữ. 
Mrĭng mrit (tt) 	Nheo nhóc.
Mrŏ mrŏ (tt) 	Ru ruô. Grăp hruê mro\ mro\ kơ sang: Suốt ngày cứ ru ruô trong nhà.
Mrô (dt) 	Số. Mrô h’ayø: Số 0; Mrô klah: Số lẻ; Mrô kruôp: Số chăôïn. 
Mruăt (bi ruăt) (đgt)	Hối
Mrŭ mrŭ (tt) 	Giống như mro\ mro\ (phương ngữ). 
Mrŭk mrĭk (tt) 	Xù xeã.
Mrŭñ mrêñ (tt) 	Dữ tợn.
Mrưh (tt) 	Láo xược
Msa (dt) 	Một cây trong bộ khung cửi. 
Msah (tt) 	Eõớt. Adiê hjan msah ao: trời mưa ướt áo.
Msah plô̆(tt)	Eõớt nhẹp. 
Msan (dt) 	Sừng (tê giác). Rông êmeh pioh mă msan: Nuôi tê giác để lấy sừng. 
Msao (đgt) 	Cãi vã. Klei mdjip mdjap snăn bi msao he\ tơl sa hruê mơh: Chuyện vớ vẩn mà cũng cãi vã cả ngày.
Msat (dt) 	Mộ
Msăm	I.(tt) chua. Boh krue# ]êyû bơ\ng msăm: trái chanh ăn chua. 
	Ii. (đgt) đăp. Adiê hlơr amâo guôn msăm abăn ôh. Trời nóng không cần đăp chăn.
Msăm plăk (tt)	Chua lè.
Msăng (bi săng) (đgt) 	Làm cho thấu hiểu.
Msăt (dt) 	Rốn. EYÕ le\ msăt leh ka?: Em beô đã rụng rốn chưa?.H’ô ao êdah msăt: Mặc áo hở rốn. 
Msâo (đgt)	Ngứa. Pe\ êtak mtah msâo kngan: Hái đậu xanh bị ngứa tay.  
Msâo msañ (đgt)	Ngứa ngáy. Mđung mdiê msâo msayû: Rê luôa ngứa ngáy.
Msei (dt) 	Săt. Ngă mnư\ ho\ng msei: Làm hàng rào băôûng săt. 
Msei sđeng (dt) 	Xà beng.  
Msĕ (tt)	Giống. Anak mse\ ho\ng ama: Con giống bố. 
Msĕ nik (tt)  	Giống hệt. Di yûu dua mse\ nik : Hai đứa giống hệt. 
Msĕ si (tt) 	Giống như
Msip msap (tt) 	Luộm thuộm. }u\t h’ô msip msap: aûn mặc luộm thuộm. 
Msir (đgt) 	1. Bít
	2. Dàn xếp. Msir klei mâo dua nah: Dàn xếp việc xích mích hai bên. 
Msir kđi (đgt)	Hị giải. 
Msir nư (đgt)	Trả nợ. Leh jih msir nư  snăn kơh tơ dah lo\ ]iăng ]an: Khi mà trả nợ xong xuôi mới vay lại. 
Msĭn (tt) 	Mặn. Eùa ksyø msyøn: Biển mặn; Dưm hra hlăm djam tơl msyøn: Bỏ muối vào canh quá mặn.
Msô̆(đgt)	Làm cho thấy.
Msuê̆č (tt)	Xinh xăn
Mta (dt)	1. Măt. }ah mta: Nảy mầm.
	2. Lưỡi (dao
	3. Thứ
Mta grăm (tăng tĭt) (dt)	Con bướm ma.
Mtah (tt) 	1. Xanh
	2. Tươi. Kan mtah: Cá tươi.
	3. Sống. Eùsei mtah: cơm sống. 
Mtal myal (tt) 	Tả tơi. 
Mtam (pht)	Ngay (lập tức)
Mtao (dt) 	Vua
Mtao mtŭng (dt)	Vua chuôa.
Mtao muôr (dt) 	Mối chuôa. Hlăm sa ktue# muôr mâo sa mtao muôr. Mỗi gò mối có một con mối chuôa. 
Mtă (đgt)	Dặn. Mtă anak êlâo kơ nao: Dặn con trước luôc ra đi; Mtă ho\ng [ăng êgei: Dặn miệng.   
Mtă mtăn (đgt)	Dặn dò. Mtă kơ anak êlâo kơ nao hriăm kbưi: Dặn dò con trước luôc đi học xa. 
Mtăp (tt)	Băôûng (theo chiều cao). Khăt bi mtăp: Căt băôûng nhau.
Mtăp mđơr (tt)	Công băôûng
Mtâo (dt)	1. Con dâu
	2. Phù thuyoãoã làm hại
Mtei (dt) 	Chuối. Mtei boh [lông: Chuối hột; Mtei pha: Chuối tiêu
Mthâo (đgt) 	Cho biết
Mthĭm (đgt)	Chẹn
Mthu (đgt) 	Làm cho khô (phơi khô). Mthu ]yøm hlô rang: Làm khô (phơi khô) thịt nai.  
Mthưr (đgt) 	Gọi với
Mtian (dt)	Có bụng
Mtih 	I. (dt)phên
	Ii. (tt)trăng. Mniê anăn siam
Mting (đgt) 	Gheô vào
Mting mtuang (tt) 	Chăôûng chịt. Hruh wăk wai mting mtuang: Mạng nhện chăôûng chịt; Klei mje\ mgiăm mting mtuang: Những mối liên quan chăôûng chịt.
Mting mtung (tt) 	Cheãnh eãnh.  
Mtir (đgt)	Dính vào nhau. Mtei mtir: Chuối dính liền nhau.
Mtĭl (dt) 	Cái tô (Làm băôûng đồng
Mtĭl mtuăl (tt) 	Bận rộn. Bruă mtyøl mtuăl: Bận rộn công việc. 
Mtlai (đgt) 	Trộn
Mtlai mtlăk (đgt) 	Pha trộn.
Mtlaih (đgt) 	Giải phóng. Hruê 10 mlan 3 thu\n 1975 jing hruê bi mtlaih {uôn Ma Thuột: Ngày 10/3/1975 là ngày giải phóng Buôn Ma Thuột; Mtlaih mơ\ng hlu\n mnă klo\ng ktư\ juă: Giải phóng khỏi ách áp bức nô lệ.
Mtlăm (đgt)	Giấu (tật xấu). 
Mtlâo (đgt)	Chia làm 3. }iă boh krue# mbha mtlâo: Căt trái cam chia làm ba. 
Mtloh (đgt)	Dứt
Mtluôn (đgt)	Về phía sau (quay lại). Wơr byøt đuôn lo\ wyøt mtluôn mă đuôn : Quên mũ quay về lại lấy mũ.
Mtŏ (đgt)	Dí. Mto\ phao: Dí suông; Phung kne\ mto\ dho\ng ]iăng tle\ mă mnơ\ng: Kẻ trộm dí dao để ăn căp đồ.
Mtiŏ (đgt) 	Đua
Mtô (đgt)	Dạy
Mtô mblang (đgt)	Giảng dạy. Mtô mblang kơ yûu brei yûu thâo săng: Giảng dạy cho nó để nó am hiểu.
Mtô mjuăt (đgt)	Tập luyện
Mtơl (đgt)	Làm cho thấy. 
Mtrang (đgt)	1. Soi. Djă pui nao mtrang ajyøk: Cầm đèn đi soi ếch. 
	2. Rọi. Pui êdeh mtrang ti ală: Aoûnh đèn rọi vào măt. 
Mtroh mƀal (đgt)	Nói đại. 
Mtruh (đgt)	Đưa tin
Mtrŭn (đgt)	Đưa xuống
Mtrŭn amung (tt)	Xịu. Arăng ăl
Mtrŭt (đgt)	Thuôc eôp.
Mtrŭt mjhar (đgt)	Khuyến khích
Mtrưm (đgt)	Đín mò.
Mtrưm đaŏ (đgt)	Phán đín. {uê mjâo duah mtrưm mđao\: Thầy bói phán đín mò.
Mtuh (đgt)	1. Nổ. Min mtuh: Meãn nổ.
	2. Bị phồng. Blah djuh mtuh kngan: Bửa củi bị phồng tay. 
Mtuh bhuč (đgt)	Nổ bùm. 
Mtuh mtưh (tt)	Nghênh ngang.  
Mtuč (asâo)(đgt) 	Xua (chó) đuổi. Mtu] asâo ke\ hlô: Xua chó đuổi thuô. 
Mtun (tt)	No căng. Leh huă mnăm êa trei mtun: aûn xong rồi uống nước no căng. 
Mtung (tt)	Khểnh. Đih mtung: Năôûm khểnh.
Mtuôm (bi tuôm) (đgt)	Gặp nhau. Hmei mtuôm ti anôk bi k]ah: Chuông tôi gặp nhau nơi điểm hẹn; Hmei mtuôm lu bliư\ leh: Chuông tôi gặp nhau nhiều lần rồi.
Mtuôp (đgt)	Chăp. H’ô ao mtuôp m[lir: Mặc áo chăp vá; Mtuôp anôk tyø: Chăp chỗ bị rách.
Mtŭ (dt) 	Ngôi sao. Mtu\ tu\r: Sao mai; Mtu\ triah: Sao hôm.
Mtŭk (đgt) 	Ho. Mâo klei mtu\k: Bị ho; Mnăm êa drao mtu\k: Uống thuốc ho.
Mtŭk hnak (đgt) 	Ho lao.
Mtŭk mtŭl (tt)	Tuôi bụi
Mtưp (đgt)	Làm lây
Mu (dt)	Mũ
Muê ktơr (dt)	Râu ngô. 
M’uê (đgt) 	Aoûm khói
Muk muk (tt)	Nhồm nhịm. Huă muk muk: aûn nhồm nhịm. 
Mung (dt) 	Tên của một loại chiêng.
Mung mang (tt)	Rỗi rãi. Dôk mung mang: Ngồi rỗi rãi.
Muôr (dt) 	Mối.  Muôr riă hră m’ar: Mối xông sách vở.  
Mur (đgt) 	Khoeôt sâu. 
Mŭm (đgt) 	Mớm. Mu\m êsei kơ e\: Mớm cơm cho beô. 
Mŭn (dt) 	Mụn. Mu\n đuh bo\ [o#:  Mụn nổi đầy mặt.
Mŭng (dt) 	Màn. Pyøt kă mu\ng: Ngủ cột màn. 
M’ŭng (tt) 	Chiều chuộng. M’u\ng đei anăn anak măk: Chiều chuộng quá con hư.
Mŭñ mê̆ñ (tt) 	Lấm lem.
Mŭr êdeh (dt)	Mui xe. Mdiăng ti mu\r êdeh: Chở trên mui xe. 
Mŭr măr (tt)	Hớt hải. Ti nao mu\r mă: đi đâu mà hớt hải. 
Mŭt (đgt) 	Vào. Mu\t sang: Vào nhà.  
Mưč (tt)	Khinh. 
Mưč chưč (đgt)	Chê bai. Lu mnuih yăl dliê mư] ]hư] kơ yûu dôk dơ\ng amâo jăk: Dư luận chê bai anh ta xử sự không kheôo.   
Mưč mač (đgt)	Khinh bỉ. Mta mnuih arăng mư] ma]: Loại người đáng khinh bỉ.
Mưm (tt) 	Gần (Tận măt).  
Mưn (đgt) 	Thuê
Mưng (đgt)	Quen. Mưng kgu\ ưm: Quen dậy sớm; Mưng ho\ng angyøn adiê: Quen với khí hậu.
Mwa (dt) 	Kyoå đà.  
Mwaih (dt) 	Một lịi cây dương xỉ.
Mya (dt) 	Cá sấu. Rông mya: Nuôi cá sấu. 
Myang (tt) 	Thiêng. Dliê myang: đất thiêng; Klei ih blu\ myang êdi: Lời anh nói thiêng thật. 
Myap (đgt)	Tính kyoä.
Myah myal (tt) 	Tả tơi. }u\t ]hum ao myah myal: Mặc quần áo tả tơi. 
Myăl (đgt)	Vào chuyện. 
Myâo (tt)	Ngịi miệng nói tốt nhưng trong lòng không phải như thế.
Myŏng myưl (tt)	Bêu rếu. 
Myông (đgt)	Đùn đẩy
Myơr (đgt)  	Dâng
Myơ̆ng (đgt) 	Rồ (làm cho quay tít). Myơ\ng myơ\ng: Rồ xe.
Myui (tt)	Aõm u. Adiê hruê anei myui: hôm nay trời âm u.
Myuĭ (tt)	Mỉa mai.
Myun (tt)	May măn
Myuôl (yuôl) (đgt)	Treo lên. 
Myuôm (đgt) 	Nâng giá
Myuôm klei boh (tt) 	Làm to chuyện.
Myŭ (dt)	Theo hướng tây. Đih ko\ myu\: Năôûm đầu theo hướng tây.
Myưh m’ang (tt) 	Vênh váo.
Myư̆ myơ̆ng (tt)	Cuồn cuộn. Eùa đoh myư\ myơ\ng: Nước chảy cuồn cuộn. 
	 
N	 
	 
Nač (đgt)	Ganh tị. Mâo ai tiê na]: Tính hay ganh tị.
Nač iăng (đgt) 	Ghen gheôt
Nah (dt) 	Phía
Nah pŏk (dt)	Một nửa. Blah kơ kâo sa nah po\k: Căt cho tôi một nửa.
Nai (dt)	Giáo viên. Amyø kâo ngă nai: Mẹ tôi làm giáo viên.
Nai kai (dt)	Cán bộ công chức. 
Naih (tt)	Hiếm hoi. 
Nao (đgt)	Đi. Aguah anei kâo nao sang ]ơ: sáng nay tôi đi chợ.
Nanao (pht)	Thường xuyên
Nă (đt) 	Đấy.
Năm (dt)	Sáu. Năm boh k]ok: Sáu cái ly. 
Năng (tt) 	Xứng đáng. Năng dưi pu\ mni: Xứng đáng được khen thưởng.
Năng ai (pht)	Có lẽ
Năt (dt) 	Con xeã (con at trong bộ bài tuô lơ khơ).
Nĕ (đt)	Này
Ngai (tt)	Làm ngơ. {uh kâo ngă he\ ngai: Thấy tôi làm ngơ.
Ngai mang 	 Làm lơ như không hề quen biết. 
Ngak kkuê (đgt) 	 Ngửa cổ.
Ngañ (tt)	Eøuïn.  Ngayû mse\ anôk dôk mnia: eøuïn như chợ. 
Ngañ bañ (tt)	Eøuïn ào. Eùnai êdeh ngayû bayû: tiếng xe ồn ào.
Ngap ngap(tt)	(Năng) Chang chang. Adiê mđiă ngap ngap: Trời năng chang chang. 
Ngă (đgt)	Làm
Ngă ƀĭng găp (đgt)	Kết bạn. 
Ngă yang(đgt) 	Cuông Giàng. Ngă yang kơ asei mlei: Cuông yàng cầu mong sức khoẻ.
Ngăn (tt) 	Lặng. Adiê ngăn angyøn: Trời lặng gió.
Ngăn drăp (dt)	Tài sản. Mbha ngăn drăp kơ anak ]ô: Chia tài sản cho con cái.
Ngăn đah (dt)	Tiền bạc. K[ah ngăn đah po\k: Thiếu tiền bạc.
Ngeh ngeh (tt) 	(Lo) ngay ngáy.
Ngêč ngiâo (tt)	Ngớ. Ka la] ngê] ngiâo: Chưa nói mà đã ngớ người. 
Ngêk ngôk (tt) 	Đãng trí. Mnuih ngêk ngôk ti dưm ti wơr: người đãng trí để đâu quên đó.
Ngêñ bêñ (đgt)	Tức giận. 
Nghar pui (dt) 	Than hồng.
Ngiêk (dt) 	Chim ri. Ngiêk hiu duah [ơ\ng mdiê bi phung: Chim ri kiếm ăn luôa theo từng đàn. 
Ngiêr (đgt) 	Quay (đầu). Ngiêr ko\ phă ngo\: Quay đầu phía đông.
Nging ngông (tt) 	Thón thờ. 
Ngŏ (dt)	Phía đông. Yang hruê [le\ tyøng Ngo\: Mặt trời mọc ở phía đông.
Ngŏk (tt)	Ngẩn.  Hlo\ng ngo\k he\: Ngẩn người ra.
Ngŏng (tt)	Ngẩn ngơ. 
Ngôk (đgt) 	Uống (ực một hơi).
Ngông (dt)	Ngỗng. Sang rông ngông: Nhà nuôi con ngỗng. 
Ngơ ngăr (tt)	Cứng đầu (Tỏ thái độ không vừa yô).
Ngơ ngăk (đgt)	Ngất. Le\ buh djiê hwăt ngơ ngăk: Teô ngã ngất xỉu.
Ngơ ngŏk (tt)	Ngẩn người ra.
Ngơ ngĕ (tt)	Chăm chuô. Dôk hmư\ ngơ nge\ : Chăm chuô lăng nghe.
Ngơ ngĭn (tt)	Lặng như tờ (nước).
Ngơ ngông (tt)	Tịt
Ngơ ngŭk (tt) 	Uoù rũ. Dôk ngơ ngu\k: Ngồi ủ rũ.
Ngơ ngư̆ (tt)	Thiu thiu (ngủ). }iăng pyøt ngơ ngư\: Thiu thiu buồn ngủ.
Ngơi (tt)	Làm lơ. {uh kâo ngă he\ ngơi: Thấy tôi làm lơ.
Ngua kŏ (đgt)	Dội lên đầu.   
Ngur (tt)	(Trái) ương.
Ngur buč (tt)	Chín rục. Boh ksă ngur bu]: Qủa chín rục.
Ngŭr ngăr (đgt)	Lăc đầu (tỏ thái độ không vừa lòng).
Ngưk kŏ (đgt)	Ngước đầu
Ngưñ ngưñ (đgt)	Dứ (làm cho thèm). Ngưyû ngưyû ]iăng [ơ\ng [êyû kâo: Cho thèm ăn bánh nè.
Nhô (tt)	Bầu dục. {o# nhô:  Khuôn mặt trái xoan.
Ni na ( dt) 	Rêu.
Nik (tt)	Rõ. Dlăng bi nik: Nheãn cho rõ. Ka thâo klă nik: Chưa biết rõ.
Nik tam (tt)	Rõ ràng. 
Niê (dt)	Họ Niê của người Êđê.
N’nung (dt)	Thòng lọng. Klam kyâo n’nung: Vác cây thòng lòng.
No	Keãa. No yûu anăn: Nó kia keãa. 
Nŏ	Đấy
Nơ nŭr (đgt) 	(Rốn) lồi ra.
Nơ̆ng dŏ (đt) 	Cái geã. Nơ\ng do\ anei?:  Cái geã đây?.
Nô (dt)	Con cưng (gọi con trai). 
Nun (kan ênun) (dt) 	(Cá) chạch.
Nut (dt)	Nuôt. Ao tloh boh nut: Aoûo đứt nuôt; Kă boh nut ao: Kết nuôt áo.
Nŭñ nêñ (tt)	Dữ tợn. 
Nư (dt)	Nợ. Đuôm nư: Măc nợ; Tla nư: Trả nợ. 
	 
~	 
	 
~Ač (đgt)	Truông
~Ah (đgt)	Bùng ra
~Ah đuê̆ (đgt)	Xa lánh. Aáah đue# kơ [yøng găp: Xa lánh bạn bè.
~Ah ñañ (tt)	Eoûo le. Klei truh yûah yûayû: Cảnh ngộ eôo le.
~Ao ñao (tt)	1. Từ chỉ âm thanh thanh ve ve. Wai yut myûê yûao yûao: Ve sầu kêu ve ve.
	2. Eøuïn ào.
	3. Leôo nheôo. Mâo asăp iêo yûao yûao hlăm êlan: Có tiếng gọi leôo nheôo ngịi đường.
~Ap ñap (tt)	Uòn ùn. Knam ju\ yûap yûap đyø hriê: Mây đen ùn ùn keôo đến.
~Ăk (đgt)	1. Nhấc
	2. Nhăc nhở. Aáăk anak ]ô ti sang hriăm hră: Nhăc nhở con cháu ở nhà học tập.
	3. Tránh đi.
~Ăk êlan (đgt)	Tránh đường. Aáăk êlan kâo nao: Tránh đường tôi đi.
~Ăm ñăm (tt)	Lờ lợ (ngọt). Mmih yûăm yûăm: Ngọt lờ lợ.
~Ăt (đgt)	1.Im. Dôk yûăt kriêp: Im lặng; aáăt yơh!: Nín đi.
	2. Kyoå cọ. Aáăt hlăm asei mlei: Kyoå cọ thân thể.
~Ăm ñi (tt)	Hồ đồ. Kđăm ênoh yûăm yûi: đánh giá hồ đồ; Blu\ yăl yûăm yûi: aûn nói hồ đồ.
~Eh (đgt)	1. Bấm. Aáeh djiêu tlao bi k’iăk: Bấm nhau cười khuôc khích.
	2. Hất. Aáeh kkiêng kngan: Hất khuyoãu tay.
	3. Hích. Aáeh kkiêng kngan ti grưh [yøng găp bi mthâo: Hích khuyoãu tay vào sườn bạn ra hiệu.
~Ĕ (đgt)	1. Giãn. Mnuih yûe\ đue# brei kơ êdeh găn nao: Người giãn ra cho xe qua lại.
	2. Neô. Dôk yûe\ tyøng sa nah: đứng neô sang một bên.
	3. Tránh.
~E dê̆č (đgt)	Neô tránh. Ală dlăng yûe\ de#]: Cái nheãn neô tránh.
~Eng ñŏng (đgt)	Nhong nhong. Eùran yûe\ng yûo\ng: Chạy nhong nhong.
~Ê̆č (đgt)	1. Vò. Aáe#] ]hum ao: Vò quần áo. Aáe#] djam hla hbei tao: Vò rau lang.
	2. Nghiền. 
~Ê̆ñ (đgt)	Làm nhàu. 
~Ê̆ñ m’ar (đgt)	Làm nhàu giấy.
~Ê̆ñ ñê (tt)	Tít. {u\k kpre#YÛ yûe#YÛ yûê: Tóc xoăn tít. 
~Iêp (tt)	Ngon. 
~Il ñil (tt)	Giôn giốt. Msăm yûil yûil: Giôn giốt chua.
~Ip (dt)	Nhíp. {u\] mlâo mu\YÛ kang ho\ng yûip: Nhổ râu băôûng nhíp.
~It ñit (đgt)	Măc kẹt (đi xe mưa lầy
~Ĭng (đgt)	Măc phải. Đuôm yûyøng ti anăn: Măc ở đó.
~Ĭp (tt)	(Tính teãnh) Nghiêm tuôc.
~Hŏk (đgt)	Thót. Kdjăt yûho\k asei mlei mse\ si pui kmlă ke\: Thót người như bị điện giật.
~Hŏk ñhŏk (đgt)	Thon thót. Kdjăt yûho\k yûho\k: Giật meãnh thon thót.
~Oh ñăt (tt)	1. Hộc tốc. Aáoh yûăt êran nao hưn ]iăng bi hmao: Hộc tốc chạy đi báo tin cho kịp.
	2. Tất bật. Aáoh yûăt ]hyø mnơ\ng: Tất bật bán hàng.
~Ŏng ñŏng (đgt)	Lăng xăng. Aáo\ng yûo\ng êran wyøt êran nao: Lăng xăng chạy tới chạy lui.
~Ơ hñăn (tt)	Ruôm. Hrut yûơ hyûăn asei mlei: Co ruôm người lại.
~Ơ hñê̆ñ (tt)	Xệch. {o# mta kwiâo yûơ hyûe#YÛ kyua ruă: Mặt meôo xệch veã đau.
~Ơ ñă (đgt)	Rịt. Păn yûơ yûă ti amyø: Bám rịt lấy mẹ.
~Ơ ñĕ (đgt)	1. Rịt (chặp). Krơ\ng yûơ yûe\ ti sang: Giữ rịt ở nhà.
	2. Chịt. Djă yûơ yûe\ hră băo: Giữ chịt lấy tờ báo.
~U (đt)	Nó
~U pô 	Meãnh. Aáu kno\ng myøn yûu pô: Nó chỉ nghĩ đến meãnh.
~Uăl (dt)	Lưới. Dăng yûuăl: Thả lưới. 
~Uh ñuh (tt)	Từ chỉ âm thanh sột soạt.
~Uôm (đgt)	Nhuộm. Mnal yûuôm êa hrah: Vải nhuộm màu đỏ.
~Uôt (tt)	Dai. }yøm yûuôt đei
~Ur (đgt)	1. Lẩn. Aáur mse\ si kan tluôr: Lẩn như chạch.
	2. Lủi. Aáur mse\ si ]yøm ku\k: Lủi như cuốc.
	3. Bò
	4. Chen. Aáur mu\t hlăm anôk lu mnuih: Chen vào đám đông.
~Ur ăm (đgt)	Lùi. Aáur ăm hbei tao: Lùi khoai lang.
~Ur hiu (đgt)	Lủi. Aáur hiu mu\t hlăm mnuih lu: Lủi vào đám đông.
~Ur ñŭ (đgt)	Ruôc. Mja yûur yûu\ hlăm [ur kyâo: Con cáo ruôc vào bụi cây.
~U (đgt)	1. Hụp. Phung hđeh mnei êjai yûu\ êjai hlăm êa krông: Bọn trẻ vừa tăm vừa hụp dưới sông.
	2. Lặn. Aáu\ sa êwa sui syøn: Lặn một hơi dài; Mnuih yûu\ êa: Thợ lặn.
~U kma (đgt)	Tham dự. Aáu\ kma anôk k[yøn: Tham dự hội nghị.
~Uñ ñê̆ñ (tt)	Nhăn nhó. Jih sa hruê yûu\YÛ yûe#YÛ: Suốt ngày nhăn nhó.
~Ut (tt)	E dè. 
	 
O	 
	 
Oč oč (tt)	(đói) Cồn cào. Eùpa tian o] o]: đói bụng cồn cào.
O oăr	Từ chỉ âm thanh tiếng xe máy. Eùnai êdeh o oăr: Tiếng xe.
Ot ot	Từ chỉ âm thanh gọi heo về ăn.
	 
O|	 
	 
O|ng (đt)	Mày (xưng hô thân mật với người ngang hàng hay hàng dưới). Oyõng nao anôk kâo ho\: Mày đến chỗ tao nheô.
	 
O	 
	 
O ô (tt)	1. Hu hu (mô tả tiếng khóc).
	2. Từ chỉ âm thanh rào rào. Hjan hriê ô ô: Mưa rào rào.
Oč ôč (tt)	Reng reng (mô phỏng tiếng lục lạc kêu).
Oh (tt)	Không (từ phủ định). Amâo mâo hmư\ sa mta ôh: Không nghe thấy geã.
Ok (dt)	Gian trong
Ong ông (tt)	Rào rào.
O- ê̆č (dt)	Loạt. Mkra mjing ô- e#] mnơ\ng yua: Sản xuất hàng loạt dụng cụ.
	 
O$	 
	 
O$ 	I. (đgt) 1.ooûi
	2. Thổ. O$ êrah: Thổ ra máu.
	Ii. (dt) mang. O$ kan: mang cá.
O$ eh (dt)	Tả (dịch tả). Tlo\ mgang klei ruă o# eh: Tiêm phòng tả.
	 
Ơ	 
	 
Ơ (tht)	1.vâng
	2. Thưa.
	3. Eû
	4. Eõò. Aáu ơ leh: Anh ấy ừ rồi.
	5. Eøuï. Eû! Kâo lo\ hdơr leh: eøuï! Tôi nhớ ra rồi.
Ơ hĕ	Eõò nhỉ. Eû he\
Ơ ơh (pht)	Eõoû
Ơ yang (dt)	Trời.
Ơ|k ơ̆k (tt)	Từ chỉ âm thanh tiếng nấc ậc ậc (khậc khậc). Tăk mnâo ơ\k ơ\k: Nấc cục ậc ậc.
Ơi (tht)	Eûi (để gọi).
Ơih (tht)	Eûi
	 
Ơ|	 
	 
Ơ|	Có
Ơ|ng (tt)	1. Tái. Klyøt ơ\ng mse\ si pak hla: Da tái như tàu lá.
	2. Tái meôt. Leh êngoh
Ơ|ng mơ hmăp (tt)	Xanh meôt. Klyøt ơ\ng mơ hmăp kyua êngoh ktư\ yơ\ng: Da xanh meôt veã sốt reôt.
Ơ|r ơ̆r (tt)	Từ chỉ âm thanh xôn xao. Eùnai blu\ ơ\r ơ\r: Tiếng nói xôn xao.
	 
P	 
	 
Pa (đgt)	Dang. Pa kngan: Dang tay.
Pač ƀô̆(đgt)	Rửa mặt. Miêu pa] [o#: Con mèo rửa mặt.
Pah (đgt)	1. Vỗ. Pah đah da: Vỗ ngực; Pah kngan: Vỗ tay.
	2. Tát. Pah miêng: Tát tai.
	3. Đánh. Pah boh đung: đánh bóng chuyền.
Pah pač (tt)	Lật đật. Ti ih nao pah pa] anăn?: đi đâu mà lật đật thế?.
Pah mưn (đgt)	Thuê mướn.
Pai (dt)	Con thỏ. Pai dliê: Thỏ rừng; Pai [ơ\ng rơ\k: Thỏ ăn cỏ.
Pai mă (đgt)	Với lấy. Pai mă kâo đa: Với lấy giùm tôi.
Paih (đgt) 	Bươi
Pak (dt)	1. Bẹ. Pak mtei: Bẹ chuối.
	2. Tàu. Pak đung: Tàu dừa.
Pam (đgt)	Luôt. Rơ\k pam mdiê: Cỏ luôt luôa.
Pan lŭ (dt)	Con trùn (giun).
Pang (đgt)	Ngăn
Pao (đgt)	Đánh. Pao ti ko\: đánh vào đầu.
Pap (dt)	Tội. 
Pap brei (đgt)	Tha thứ. 
Pap đei (tt)	Tội lăm.
Pap mñai (tt) 	Tội nghiệp. 
Pat	I. (dt) kan pat: cá diếc.
	Ii. (đgt) vót. Pat đrao bi knur: vót nứa cho nhọn.
Pă (dt)	Bốn. Mrô pă: Số bốn; Pă drei asâo: Bốn con chó.
Păk (tt)	Tách (tiếng nổ). Kpu\ng mtuh myûê păk: Bong bóng nổ tách.
Păk kê (dt)	Tăc kè.
Păk kra (dt) 	Chim đa đa.
Păl ak (dt)	Nách. Mlâo păl ak: Lông nách.
Păl ao (dt)	Tay áo. Ana păl ao: Cây hà thủ ô. 
Păl bŏk (dt)	Băp tay.
Păl kngan (dt) 	Cánh tay. 
Păm (dt)	Ana păm: Cây bồ kết; Boh păm: Trái bồ kết.
Păn (đgt)	1. Quấn. Păn ]hiăm: Quấn khăn.
	2. Đóng. Păn kưn ti ko\: đóng khăn trên đầu.
	3. Băng bó. Păn anôk êka: Băng bó vết thương.
Păng (đgt)	1. Thưng. Mtih sang păng ho\ng kđuh: Vách nhà thưng băôûng phên.
	2. Ngăn. Păng ho\ng ]hiăm riđô: Ngăn băôûng vải phông.
Păt (dt)	Ana păt: Cây bồ hòn; Boh păt: Quả bồ hòn.
Păt čiăng (lt)	Hầu như.
Păt čiăng djŏ (lt)	Gần đuông
Păt čiăng jih (lt)	Gần hết
Păt dah (lt)	Heãnh như. Păt dah kâo tuôm leh ho\ng mniê anăn: Heãnh như tôi đã gặp cô ấy.
Păp mă (đgt)	Chộp lấy. Păp mă ti ko\: Chộp lấy ngay ở đầu.
Peh (đgt) 	Tông (nhẹ). Eùdeh peh: Xe tông.
Pen (dt) (Pr) 	Cái keãm.
Pep (đt)	Tiếng hổ kêu. Eùmông pep: Hổ kêu.
Pĕ (đgt)	1. Hái. Pe\ djam: Hái rau; Pe\ boh truôl: Hái ổi.
	2. Đánh. Pe\ bro#: đánh đàn.
Pê (tt)	Xẹp. Pông êdeh pê: Bánh xe xẹp.
Pê kdjuôt (tt)	Heôo hon. Hđeh điêt pê kdjuôt kyua dah amâo [ơ\ng mnơ\ng: đứa beô heôo hon veã không chịu ăn.
Pê puăt (tt)	Xẹp leôp. Tian pê puăt: Bụng xẹp leôp.
Pê rat (Pr) (dt) 	Du đãng
Pêng pông (tt)	Meôo
Pê̆ñ (đgt)	Huơ. Eùman pe#YÛ kngan: Voi huơ vòi.
Pha (dt)	Đùi. Pha mnu\: đùi gà.
Phai (đt)	Mở rộng ra. Phai [ăng bhă: Mở cửa rộng ra.
Phao (dt)	Suông. Boh phao: đạn.
Phao briêng (dt)	Pháo hoa. Mnah phao briêng: Băn pháo hoa.
Phao m’ar (dt)	Pháo. }uh phao m’ar: đốt pháo.
Phat (đgt)	Đục. Phat kyâo: đục cây.
Phat atâo (đgt)	Giỗ tổ tiên (Cuông người đã chết).
Phat ênoh kjoh giê (đgt)	Luận tội
Phat kđi (đgt)	Xử tội
Phă (tĭng) (dt)	Phía. Phă yu\: Phía Tây; Phă ngo\: Phía đông.
Phăk phăk (tt)	Tách tách. Pah kngan phăk phăk: Vỗ tay tách tách.
Phăl măp (tt)	Răn rỏi. Asei mlei phăl măp: Cơ thể răn rỏi.
Phăl kjăp (tt)	Chăc nịch.
Phăp (đgt)	Căm phập vào.
Phăn (đgt)	Khín. Mă bruă phăn : Làm việc khín.
Phăr (đgt)	I. (đgt) giật meãnh. Phăr kdjăt: giật meãnh; phăr mdih pyøt: giật meãnh tỉnh giấc ngủ.
	2. (pht) Chợt. Phăr hdơr: Chợt nhớ.
Phep (dt) (Yuăn)	Pheôp.
Phê drao (đgt) 	Bỏ bùa.
Phêč mčah (đgt)	Vỡ toang.
Phi (dt)	Thùng lớn (200 lít). Phi êa: Thùng nước.
Phi phi (tt)	Pheã pheã. Tlăn kpruih êa bih phi phi: Trăn phun nước bọt pheã pheã.
Phiang (đgt)	1. Lấy luôn. Aáu phiang mă mtăm: Nó lấy luôn.
	2. Trải ra. Phiang ]hiăm: Trải khăn ra.
	3. Quơ lấy. Phiang ti dho\ng: Quơ lấy dao.
Phiat kƀông (đgt) 	Bĩu môi.
Phiêng (đt)	Căn nghiêng một bên. Uyõn phiêng ho\ng êgei griăng: Heo căn băôûng răng nanh. 
Phing phing (pht)	Đùng đùng. 
Phiơr	I. (dt) eùdeh phiơr: máy bay. Kan phiơr: cá chim.
	Ii. (đgt) bay. }yøm phiơr hlăm adiê: chim bay trên trời.
Phĭ	I. (dt) mật. Phyø kgâo: mật gấu.
	II (tt) đăng. Tro\ng phyø: Cà đăng. 
Phĭ phĭt phĭt (tt)	Hơi đăng đăng.
Phĭk phĭk (tt)	Thùi thụi. }ăm phyøk phyøk: đánh thùi thụi.
Phĭk rĭk (tt)	Theãnh thịch. Kdrăm jơ\ng phyøk ryøk: Dậm chân theãnh thịch.
Phĭng ngơi (tt)	Leã lợm.
Phĭr (tt)	Dẹt. Lat phyør: Dẹp leôp.
Phĭt (tt)	Leã. Dôk phyøt amâo ]iăng wyøt: Ngồi leã không muốn về.
Phĭt ngơi (tt)	Leã lợm. Phyøt iêô hlo\ng amâo h’u\t: Leã lợm gọi không thèm thưa.
Phon (đgt)	Nhảy. Kdo\ phon: Nhảy muôa.
Phŏk phu (tt)	Hổn hển. Bi êwa pho\k phu: Thở hổn hển.
Phơ̆ng (pht)	Tloh phơ\ng: đứt phăng.
Phu phu (pht)	Phù phù. Ayu\ pui phu phu: Thổi lửa phù phù.
Phuăr (đgt)	Nhảy phóc lên. Ajyøk phuăr kdăt đue#: eùaúch nhảy phóc (đi) lên.
Phuăt tloh (đgt)	Đứt phăng. Phuăt tloh klei jao: đứt phăng dây võng.
Phuč (tt)	Đùng. Kpu\ng mtuh phu]: bong bóng nổ đùng.
Phung (dt)	Đàn
Phung êgap (dt)	Phường săn băn.
Phuôr phuôr (tt)	Háo hức. Phuôr phuôr ]iăng đue# hiu: Háo hức muốn đi chơi.
Phŭ	I. (tt) đùng. Boh kneh le\ phu\ ti lăn: quả mít rơi đùng xuống đất.
	Ii. (dt) kbâo phu\: mía lùi.
Phŭk phŭk (tt)	Thăc thỏm. Hlăm ai tiê phu\k phu\k amâo h’iêt mđao: Trong lòng thăc thỏm không yên.
Phŭl (đgt)	Bật gốc. Kyâo êbuh kbu] phu\n phu\l: Cây ngã bật gốc.
Phŭl phŭl (đgt)	Pheã phà. Dju\p hăt phu\l phu\l: Huôt thuốc pheã phà.
Phŭn (dt)	1. Gốc. Phu\n kyâo: Gốc cây.
	2. Chân. Phu\n êgei: Chân răng.
Phŭn agha (dt)	Gốc rễ
Phŭn bruă (dt)	Bộ
Phŭn dô (dt)	Xưa kia. Klei hdyøp phu\n dô dleh knap snăk: Cuộc sống xưa kia rất cực khổ.
Phŭn ksâo (dt)	Bầu vuô.
Phŭn msăt (dt)	(Cái) rốn. 
Phŭr (đgt)	Xổng ra. Mnu\ phu\r tlaih mơ\ng pông: Gà xông ra khỏi chuồng.
Phưi (đgt)	Thả. Phưi kngan: Thả tay.
Phưi tha (đgt) 	Thả rong. Rông bê phưi tha: Nuôi dê thả rong.
Phưl (đgt)	Cuốc đứt. Phưl [ur kyâo: Cuốc đứt bụi cây.
Phưp (đgt)	Bong ra. Klyøt klôk phưp: Da bị bong ra.
Pi (dt)	Buôt pi: Kèn làm băôûng cuống lá bí đỏ. 
Pi pu (tt)	Phập phồng. Bi êwa pi pu: Thở phập phồng.
Pia (dt)	Cách gọi. Si arăng pia: Người ta gọi thế nào; Boh pia: Vần; Hriăm dlăng boh pia: Tập đánh vần.
Piăng (dt)	Cá kèo.
Piăt (đgt)	Xếp gọn. Piăt ]hum ao bi ê[ăt: Xếp quần áo cho gọn.
Piăt êmiêt (đgt) 	Săp xếp. Piăt êmiêt bruă knuă: Săp xếp công việc.
Piêt (dt)	Con ve (căn trâu bò). Piêt ke\ êmô: Con ve căn con bò.
Piêu (dt)	Cái gùi. Arăng myûam piêu ho\ng m’ô: Người ta đan gùi băôûng lồ ô.
Pik (đgt) 	Thoa
Pil (pr) (dt)	Pin. 
Pin êa (dt)	Bến nước.
Pin puôn (tt)	Rụt rè.
Ping čư̆ (dt)	Triền nuôi
Ping pưng (tt)	To bản. Knga êman ping pưng êdi: Tai voi rất to bản.
Pioh 	I. (đgt) cất. Pioh ]hum ao hlăm hip mdơ\ng: cất quần áo trong tủ đứng.
	Ii.(pht) để. Asâo pioh kiă sang: chó để giữ nhà.
Piơ̆k (tt)	Xanh dương. Eùngyøt adiê piơ\k mmak: Bầu trời xanh ngăt.
Piu (dt)	Teãnh nhân.
Pĭng pŏng (dt)	Bóng bàn. Pah pyøng po\ng: đánh bóng bàn.
Pĭt (đgt)	Ngủ. Dôk pyøt: đang ngủ; pyøt gui: Ngủ gật; pyøt sngeh: Ngủ kheã.
Pla (đgt)	1. Trồng. Pla kyâo: Trồng cây.
	2. Cấy. Pla mdiê lo\: Cấy luôa ruộng.
Pla jưn (đgt)	Căm trại.
Plah (đgt)	Giành giật
Plah mă (đgt)	Chiếm đoạt.
Plah mmiă (đgt)	Xâm chiếm. Phung roh ]iăng plah mă ala ]ar drei: Bọn giặc muốn xâm chiếm nước ta.
Plah wah (đgt)	Xen giữa. Dôk plah wah: Ngồi xen giữa.
Plao 	I. (dt) 1. Đảo. Pla êa ksyø: đảo khơi (biển).
	2. Vô sinh. Mnuih plao: Người vô sinh.
	3. Mày đay (bệnh ngịi da).
	Ii. (đgt) tiễn đưa.
Plat (đgt)	Đánh
Pleh (đgt)	1. Hái. Pleh tro\ng: Hái cà. 
	2. Tước. Pleh êdu\k plei: Tước đọt bí.
	3. Tẻ. Pleh ktơr: Tẻ băp.
Pleh pliâo (đgt)	Trật (lất). Pleh pliâo jơ\ng: Trật chân.
Plă jơ̆ng (dt)	Lòng bàn chân. Aáu ruă plă jơ\ng: Nó đau lòng bàn chân.
Plă kngan (dt)	Lòng bàn tay. Plă kngan kâo mtuh: Lòng bàn tay tôi bị phồng.
Plăk wĭt (đgt)	Quay về (đi chưa đến nơi đã về giữa chừng). Aáu plăk wyøt kơ sang: Nó quay về nhà.
Plăm (dt)	Tinh hịn (động vật).
Plăn (đgt)	Trợn. Ală plăn kơ dlông: Măt trợn ngược lên.
Plăng (dt)	Cây sả. Tlê amre#] ho\ng plăng: Giã ớt với sả.
Ple, awăt (tt)	Yếu. Ple ai: Yếu sức.
Plei (dt)	Bí đỏ. Eùdu\k plei: đọt bí đỏ; Boh plei: Quả bí đỏ (bí ngô).
Plĕ (đgt)	Thả rơi. Ple\ [om: Thả bom.
Plê (dt)	Dương vật. Boh plê: Cái beãu; Grăn plê: Dương vật.
Plêč (đgt)	1. Tránh khỏi. Plê] kơ klei jhat: Tránh khỏi chuyện xấu.
	2. Vo. Plê] braih knă êsei: Vo gạo nấu cơm.
Pliah (đgt)	Sượt qua. {răm pliah ti hlô: Mũi tên sượt qua thuô.
Pliă plia (tt) 	1. Lang thang. Hiu pliă plia: đi lang thang.
	2. Bậy bạ. Ngă pliă plia: Làm bậy bạ.
	3. Bừa bãi. Dưm pliă plia: để bừa bãi.
Pliêr (dt)	1. Mưa đá. Hjan le\ pliêr: Mưa đá.
	2. Tuyết. Yan puih mâo pliêr le\: Mùa đông có tuyết rơi.
Pliêu (dt)	Chào mào.
Plim (Pr) (dt)	Giê plim: Cây buôt mực; Asei plim: Ngòi buôt mực.
Plin (đgt)	Lê la. Dôk plin: Ngồi lê la.
Plin plan (đgt)	Lê lết. Dôk plin plan: Ngồi lê lết (lết).
Pling (đgt)	Cho chảy ra. Pling êa ti êngao lo\: Cho nước chảy ra ngịi ruộng. 
Plĭng (dt)	Con cánh cam.
Plĭp (đgt)	(Đánh) vuôt. Plyøp ]ăm ho\ng giê hnuăt: (đánh) vuôt băôûng roi.
Plŏ, plŭ (đgt)	Bịch. Le\ plo\ ti lăn: Rơi bịch xuống đất.
Plue (tt)	Nhàn rỗi. Mniê anăn adôk plue: Cô ấy nhàn rỗi.
Pluh (dt)	Mười
Pluih (tt)	Thua. Bi ]ik pluih amâo dưi: Vật nhau thua không thăng được.
Plum (dt)	Con văt.
Poh (đgt)	Đập dập. Poh krum: đập dập cây nhuộm chỉ.
Poh yă (dt)	Sóng. Eùa ksyø poh yă ktang snăk: Sóng biển rất mạnh.
Pom (Pr) (đgt)	Bơm. Pom êa: Bơm nước; Pom pông êdeh: Bơm bánh xe.
Pŏ (đgt)	Bứng. Po\ kyâo ba pla ti anôk mkăn: Bứng cây đem trồng nơi khác.
Pŏk 	I. (đgt) mở. Po\k [ăng bhă: mở cửa.
	Ii. (tl) từ dùng để đếm số trang
Pŏk ƀai (đgt)	Mở rộng.
Pŏk phai ( đgt)	Mở mang.
Pŏk pui kmlăi (đgt)	Bật đèn điện.
Pô (dt)	Chủ. Pô sang: Chủ nhà.
Pô krơ̆ng (dt)	Người làm chứng.
Pô lăn (dt) 	Chủ đất (về mặt tinh thần).
Pô mphŭn čưm (dt)	Người sáng lập.
Pô phŭn (dt)	Chủ nhân. Pô phu\n ala ]ar: Chủ nhân đất nước.
Pôk (dt)	1. Bẹ. Pôk mnang: Bẹ cau.
	2. Bưn pôk: Vườn tược.
Pông (dt)	Lồng. Pông mnu\: Lồng gà. Kđeh pông: thịt thăn.
Pông êdeh (dt)	Bánh xe. Pông êdeh pêng pông: Bánh xe bị meôo.
Pông kruê (dt) 	Tay quay xa.
Pơ (tt)	Hô. Eùgei pơ: Răng hô.
Pơ pŭm (đgt)	Xoã xuống. Dhan kyâo pơ pu\m: Cành cây xoã xuống.
Pơt (tt)	Ngăn ngủn. {ar m’iêng pơt: Mặc váy ngăn ngủn.
Pơ̆i hla (đgt)	Chạy diều.
Pơ̆k (đgt)	Động tác dệt vải.
Pơ̆k mñam (dt)	Dệt vải. Yan bhang phung mniê Êđê khăng pơ\k myûam: Mùa hạ phụ nữ thường dệt vải.
Pơ̆ng (đgt)	1. Đóng. Pơ\ng msei kđyøn: đóng đinh. 
	2. Giàn đựng cơm trong nhà mồ. Ngă pơ\ng: Làm lễ bỏ mả.
Pra (dt)	Giàn. Pra êyăn: Giàn mướp; Pra pui: Giàn bếp.
Prač (tt)	(Truông) phạch.
Prah (đgt)	1. Dập. Prah pui: Dập lửa.
	2. Đập. Prah mdiê: đập luôa.
Prah prač (tt)	Vương vãi. Ngă prah pra]: Làm vương vãi.
Praih (tt)	Rơi vãi. EYÕ praih êsei: Beô làm rơi vãi cơm.
Pral (tt)	Nhanh. Eùbat pral: đi nhanh.
Praĭ (dt)	1. Mỡ. Prayø u\n: Mỡ heo.
	2. Eùa prayø: Dầu. Eùa prayø êtak lăn: Dầu đậu phụng.
Pram (đgt)	Rấp (lấp). Pram êruê: Rấp lối đi. Prah êjam pram êruê: Hành vi thái độ chống đối.
Prang (đgt)	Chỉ động tác gà mẹ xù lông xoè cánh bảo vệ con.
Prao 	Tên chung của các lịi răn to. Prao ju\: Răn hổ trăn (hổ đất); Prao hbâo: Răn hổ mang.
Pră 	I. (đgt) tít ra. Pră [le\ êa k’ho\: tít mồ hôi ra.
	2. Rơi tõm. Le\ pră hlăm êa: Rơi tõm xuống nước.
	Ii. (dt) bạc (kim loại).
Prăk (dt)	1. Tiền. Prăk mlan: Tiền lương tháng. 
	2. Bạc. Kông prăk: Vòng bạc.
Prăk hliê (dt)	Tiền lẻ.
Prăk kăk (dt)	Tiền bạc. Amâo mâo prăk kăk: Không có tiền bạc. 
Prăm (tt)	Thâm
Prăm jŭ (tt) 	Thâm tím. {o# mta prăm ju\: Mặt mũi thâm tím. 
Prăn (dt)	Vết lăôûn do roi đánh.
Prăng (dt)	Pháp. Ala ]ar Prăng: Nước Pháp; Phung Prăng: Người Pháp.
Prăp (đgt)	Sửa soạn. Prăp m’iêng ao: Sửa soạn váy áo.
Prăp êmiêt (đgt)	Chuẩn bị. 
Prăt (tt) 	Xơ xác. Ana kyâo prăt hla: Cây xơ xác lá.
Pre (dt)	Thăng
Prĕ prĕ (tt)	1. Lâm râm. Hjan pre\ pre\: Mưa lâm râm.
	2. Nho nhỏ. La] pre\ pre\: Nói nho nhỏ.
Pri (Pr) (dt)	Phần thưởng. Aáu mâo mă pri: Nó được phần thưởng.
Pri pria (đgt)	Xoè. M’iêng pri pria: Váy xoè.
Priêl (đgt)	Chọc tức. Đăm priêl kâo ôh: đừng chọc tức tôi.
Priêng (dt) 	Thính (gạo rang xay). }yøm êmô lu\k priêng: Thịt bò trộn thính.
Prih (tt)	Tua tủa. Dhan kyâo prih êruê: Cành cây tua tủa gai.
Prin prun (tt)	Khệ nệ. Tian pro\ng prin prun: Bụng to khệ nệ.
Pring (đgt)	Tập bay. }yøm pring êđai: Chim tập bay cho chim con.
Priu (đgt)	Nổi da gà
Priu ê-ăt (tt)	Eûoûn lạnh. Asei mlei priu ê- ăt: cơ thể ớn lạnh.
Prĭl (dt)	Tro\ng pryøl: Cà rí. {ơ\ng djam pryøl: aûn canh cà rí.
Proh (đgt)	Xói mòn. Eùa proh lăn jăk: Nước xói mòn đất tốt.
Proh ĭ (đgt)	Sâoãy thai.
Prŏng (tt)	To
Prŏng prĭn (tt) 	To lớn.
Prŏng pơ̆k (tt)	To bản. Eùgei pro\ng pơ\k: Răng to.
Prôč (dt)	Ruột. Prô] mda: Ruột non. Prô] khua: Ruột già.
Prôč êbeh (dt)	Ruột thừa.
Prôk (dt)	Con sóc. Prôk djo\ [ưi: Con sóc truông bóy.
Prơ̆ng 	I. (dt)
	Ii. (tt) dữ. Mnu\ ana prơ\ng: gà mái dữ.
Prơ̆ng puôt (dt)	Cái giỏ để tuốt luôa.
Pruč (tt)	Toẹt. K]uh pru]: Nhổ toẹt.
Pruê (đgt)	Rải
Pruê hbâo (đgt)	Bón phân.
Pruê̆ (dt)	1. Câu. Prue# blu\: Câu nói. 
	2. Dãy. Prue# mdo#: Dãy ghế.
	3. Dòng. }ih sa prue#: Viết một dòng.
	4. Hàng. Dăp prue#: Xếp hàng.
Pruih (đgt)	Xịt
Prung (dt)	Cái gùi đan thưa.
Prŭ prŭ (đgt) 	Aòo ào. Hjan pru\ pru\: Mưa ào ào.
Prŭk (đgt)	Phập
Prŭng (đgt)	Xua
Prŭt, pruăt (đgt)	Đứt phăng. Koh tloh pru\t: chặt đứt phăng.
Prưh (đgt)	Đuổi đi. Yang prưh: thần đuổi đi.
Prưng prang ( đgt) 	Xua đuổi. Ya ngă ih prưng prang gơ\: Tại sao anh xua đuổi nó.
Pu pi (tt)	Mũm mĩm. Miêng pu pi: Má mũm mĩm.
Puah (đgt)	Thiến. Ayo\ng kâo puah u\n: Anh tôi thiến heo.
Puăn (dt)	Djam puăn: Rau muống.
Puăng (dt)	Điểm. Puăng jăk: điểm tốt.
Puh (đgt)	I. 1. Lùa. Puh êmô kbao: lùa trâu bò.
	2. Thổi. Angyøn puh knam nao kơ yu\: Gió thổi mây đen về phía tây.
	Ii. (tt) bạc màu. Ao puh: aoûo bạc màu.
Pui (dt)	Lửa. Răm pui
Pui ƀơ̆ng (đgt)	Cháy. Pui [ơ\ng dliê: Cháy rừng. 
Pui hrip (đgt)	Điện giật.
Pui kƀong ( dt)	Đuốc. Djă pui k[ong nao mtrang ajik: cầm đuốc đi soi ếch.
Pui kmlă (dt)	Điện. Ară anei djăp [uôn sang mâo leh pui kmlă s’ayø: hiện nay các buôn làng đều đã có điện.
Pui ktuê (đgt)	Cháy lan.
Pui pit (dt)	Đèn pin.
Puih (dt)	Đông. Yan puih: mùa đông. Angyøn puih: gió đông.
Pum (dt)	Bụi
Pum kyâo (dt)	Bụi cây. Bhyøt pum: Bụi rậm; Pum êruê: Bụi gai.
Pum yă pum yai (tt)	Um tùm. Kyâo mtâo pum yă pum yai: Cây cối um tùm.
Pun 	I. (dt) }yøm pun: con cheo. 
	Ii. (đgt) uoù ấm. Ana mnu\ pun êđai ti gu\ siap: gà mẹ ủ ấm con dưới cánh.
Puôr (dt) 	Eùa puôr: Mồ hôi trộm.
Puôt (đgt)	Tuốt. Puôt mdiê: Tuốt luôa.
Puôt wiă (đgt)	Gặt hái.
Put (dt)	Ana put: Cây bấc.
Put mtuh (dt)	Thuốc nổ.
Pŭ (đgt) 	1. Bế
	2. Bê. Pu\ klo\ boh tâo: Bê cục đá. 
	3. Cất. Pu\ đrư\: Cất vó.
Pŭk (đgt)	Quậy. Eùman pu\k êa: Voi quậy nước.
Pŭk ală (dt)	Mi măt. Mlâo pu\k ală: Lông mày.
Pŭk piăk (tt)	Nhợt nhạt. {o# mta pu\k piăk: Mặt mũi nhợt nhạt.
Pŭl (pht)	Bệt.
Pŭng (dt)	Hbei pu\ng: Khoai từ.
Pŭñ pañ, puñ pêñ (tt)	Đen đủi. {o# mta pu\yû payû: mặt mũi đen đủi.
Pŭr (dt)	Răôûm. Mlan pu\r: Trăng răôûm.
Pưč (đgt) 	Lột xem. Pư] ktơr: Lột xem băp.
Pưh (đgt)	1. Quạt. Pưh pui: Quạt lửa.
	2. Thổi. Angyøn pưh: Gió thổi.
Pưi (đgt)	Vóy. Pưi kngan: Vóy tay.
Pưk (dt)	Cái chòi. Pưk hlăm hma: Chòi trên róy.
Pưng (đgt)	Tạt đi. Angyøn pưng: Gió tạt đi.
Pưu pưu (tt)	(Nói) to. Blu\ pưu pưu: Nói to.
	 
R	 
	 
Rač (đgt)	1. Bứt. Ra] boh nu\t ao: Bứt nuôt áo.
	2. Suốt
Rah (đgt)	Gieo. Rah mdiê: Gieo luôa.
Rai 	I. (dt) anak rai: con rồng.
	Ii. (tt) tan nát. Phung roh bi rai [uôn sang: bọn giặc gây tan nát làng xóm.
Rai brŭ (tt)	Thối nát.
Rai lik (tt) 	Tan nát.
Rai răk (tt) 	Tan tành. K]ok m]ah rai răk: Ly vỡ tan tành.
Rai tuič (tt)	Tan rã. Eùpul di yûu rai tui] leh: Nhóm của họ đã tan rã.
Raih 	I. (dt) bươi ra.
	Ii. (tt) thạo. Aáu thâo raih klei êđê: nó biết thạo tiếng êđê.
Raih tô (dt)	Anh em cọc chèo (đồng hao).
Rak (tt)	Hườm. Boh suai rak kyûyø: Quả xịi vàng hườm.
Ram (tt)	Tàn. Pui ram: Lửa tàn.
Ram rai (tt)	1. Tan hoang. Ram rai  [uôn sang: Tan hoang buôn làng.
	2. Tàn lụi.
Rang  (đgt) 	1. Phơi. Ala kbiă rang mđiă: Con răn ra phơi năng.
	2. Bày ra. Rang mnơ\ng ]hyø: Bày mnơ\ng ]hyø: Bày hàng bán.
Rang angĭn (đgt)	Hóng gió
Rañ (tt)	1. Căng. Ksâo rayû: Vuô căng sữa.
	2. Nghiện. Rayû kpiê: Nghiện rượu.
Rao (đgt)	Rửa. Rao ]hiên mngan: Rửa cheôn bát.
Ră (tt)	Tham. Ră [ơ\ng: Tham ăn.
Ră ră (tt)	Rả rích. Adiê hjan ră ră: Trời mưa rả rích.
Răk (đgt)	1. Kể. Lo\ răk: Kể lại. 
Răk tuič (đgt)	Thuộc lòng. Klei hriăm răk tui]: Bài học thuộc.
Răm pui (đgt)	Nhóm lửa. Amyø kâo răm pui: Mẹ tôi nhóm lửa.
Răng (đgt)	Giữ. Răng pưk sang: Giữ nhà cửa.
Răng kriê (đgt)	Giữ geãn. Răng kriê klei bi mdoh asei mlei: Giữ geãn vệ sinh thân thể.
Răng mgang (đgt)	Phòng ngừa. Răng mgang klei ruă: Phòng ngừa bệnh tật.
Răng pioh (đgt)	Lưu giữ (lưu truyền).
Răp răp (tt)	Ra rả. Blu\ răp răp: Nói ra rả.
Reh (đgt)	1. Căt. Reh ]hum ao: Căt quần áo.
	2. Thái. Reh hăt: Thái thuốc lá.
Riap (đgt)	(đan) Lát. Tria sang riap ho\ng kram: Sàn nhà lát băôûng tre.
Riă (đgt)	Ninh
Riăk riăk (tt)	Reng reng. Eùriâo myûê riăk riăk: Lục lạc kêu reng reng.
Riăng (đgt)	Dăt (tay). Riăng hđeh ti kngan: Dăt trẻ trong tay.
Riăp riăp (tt)	Rào rào. Hjan riăp riăp: Mưa rào rào.
Riêk (đgt)	Rạch. Reh kdô: Rạch tuôi.
Riêl (tt)	Leã lợm. 
Riêm (đgt)	Viền. Riêm kkuê ao: Viền cổ áo.
Riêng gah (tt)	Xung quanh. Sang riêng gah: Nhà xung quanh.
Riêu (dt)	Cái gùi của người Jrai.
Ring 	I. (đgt)1. Bi ring: đổi công.
	2. Hriăm ring: Tập đi.
	Ii. (tt). Xiêu vẹo. Sang ring: nhà xiêu vẹo.
Ring ba (đgt)	Deãu dăt. Amai ring ba adei: Chị deãu dăt em.
Ring rang (tt) 	Loạng choạng. Eùbat ring rang: đi loạng choạng.
Riŏ (đgt)	Nghiến
Rit (đgt)	Xích lại. Rit giăm ti anei: Xích lại gần đây.
Riu (đgt)	Rê. Riu mdiê: Rê luôa.
Riu yang (đgt)	Cuông giàng.
Rĭng 	I. (đgt) 1. Nộp. Ryøng jia: thu thuế. 
	2. Chiêu mộ
	Ii. (dt) bộ. Sa ryøng ]ing: một bộ chiêng.
Rĭng riâo (dt)	Chũm choẹ
Rĭng prăk (đgt)	Thu tiền.
Rĭng rai (dt) 	Con ve (sầu). Ryøng rai myûê hao hao: Ve kêu ầm ĩ. 
Rĭt (đgt)	Xê
Roh (dt)	1. Giặc. Phung roh măk [ai snăk: Bọn giặc rất tàn bạo.
	2. Reãa. Roh hma: Reãa (beãa) róy; Jah roh: Phát beãa (reãa) róy.
Roh gah (dt) 	Giặc giã.
Rom (dt)	Kpiê rom: Rượu rum.
Rŏng (dt)	Lưng. Ro\ng ku\ng: Lưng còng.
Rŏng jơ̆ng (dt)	Mu bàn chân.
Rŏng lăn (dt) 	Mặt đất.
Rŏng rai (dt)	Chít (sau chuôt).
Rŏng rĕ (dt)	Chuôt. (}ô: Cháu; }e\: Chăt; Ro\ng re\: Chuôt).
Rô (dt)	Chuồng gia cầm. Rô mnu\: Chuồng gà. Rô bip: Chuồng vịt.
Rôč (đgt)	1. Rơi. Rô] êa ală: Rơi lệ.
	2. Nhỏ giọt. Phin kphê rô]: Phin cà phê nhỏ giọt.
Rôk (đgt)	Đi qua đám đông. Đyø êlan ôk rôk êlan gah: đi từ phía hiên sau qua phía hiên trước.
Rông (đgt)	Nuôi. Rông anak: Nuôi con; Pô rông: Người nuôi.
Rông ba (đgt)	Nuôi nấng.
Rông mnơ̆ng (dt)	Chăn nuôi.
Rô̆(đgt) 	Vượt qua. Ro# bhyøt pum: Vượt qua bụi rậm.
Rơ riăp (đgt)	Rào rào. Hjan rơ riăp: Mưa rào rào.
Rơ riêm (tt)	Chi chít. Boh nut ao rơ riêm: Nuôt áo chi chít.
Rơ rôč (tt)	Ròng ròng. Eùrah [le\ rơ rô]: Máu chảy ròng ròng.
Rơi (tt) 	Vừa thưa vừa hô. Eùgei rơi: Răng vừa thưa vừa hô.
Rơ̆k (dt)	Cỏ. Rơ\k mda: Cỏ non.
Rơ̆k sĭk (dt)	Cỏ may.
Rơ̆k tơ̆k (dt)	Cây cỏ. Yan hjan rơ\k tơ\k mda djưt: Mùa mưa cây cỏ xanh tươi.
Rơ̆ng (tt)	Bền
Ru (đgt)	Đổ từ chai
Ruah (đgt)	Chọn lọc. Ruah mjeh: Chọn giống.
Ruah khua (đgt)	Bầu cử. Nao ruah khua: đi bầu cử.
Ruah mă (đgt)	Chọn lấy.
Ruă (đgt)	1. Đau. Ruă jơ\ng: đau chân; Ruă tian: đau bụng.
	2. Bệnh. Klei ruă: Bệnh.
Ruă duam (đgt)	Đau ốm. Aáu khăng ruă duam: nó thường đau ốm.
Ruă kjham (đgt)	Đau nặng.
Ruă tuit (đgt) 	Đau quặn.
Ruăt (tt)	Vội. Aáu ruăt nao mă bruă: Nó vội đi làm việc.
Ruăt kuăt (tt)	Vội vàng. Ti ih nao ruăt kuăt anăn: Anh đi đâu mà vội vàng thế.
Ruê (dt)	Con ruồi. Đăm brei ruê gam hlăm mnơ\ng [ơ\ng: đừng cho ruồi đậu vào thức ăn.
Ruêh (đgt)	Sờ. Ruêh ko\: Sờ đầu.
Ruê̆ ( đgt)	1. Kết thuôc. Rue# gưl hriăm: Kết thuôc khí học.
	2. Đi thành đàn. Hdăm rue# nao kơ [ăng: Kiến bò về hang.
Ruh (đgt)	1. Mở ra. Ruh hruh [êyû: Mở gói bánh.
	2. Gỡ
Ruh ksiêm (đgt)	Nhận xeôt.
Ruh rah (tt)	Lai rai. Hjan ruh rai: Mưa lai rai.
Ruh ruah (pht)	Rục rịch. 
Rui (đgt)	Bò. Hđeh điêt hriăm rui: Em beô tập bò.
Ruih (dt)	Ghẻ. Aáu bi ruih: Nó bị ghẻ.
Ruih keh (dt)	Ghẻ lở.
Ruôm (tt)	Tấy. Jơ\ng bo\k ruôm: Chân sưng tấy.
Ruôp (pht) 	Mãi
Ruôt (đgt) 	Thăt. Ruôt kkuê êmô: Thăt cổ bò.
Rup (dt)	1. Heãnh. Mă rup: Chụp heãnh; }ih rup: Vẽ heãnh. 
	2. Tượng. Rup hlăm msat: Tượng nhà mồ.
Rŭ (đgt) 	1. Nhổ. Ru\ kpơ\ng: Nhổ gốc cây.
	2. Nhuô. Eùgei mrâo ru\: Răng mới nhuô.
	3. Vực dậy
	4. Bứng. Ru\ ana kyâo: Bứng cây.
	5. Nâng. Amai êbuh êdei ru\: Chị ngã em nâng.
Rŭ êmŏng (tt) 	Nở nang. Asei mlei ru\ êmo\ng: Thân heãnh nở nang.
Rŭ ênua (đgt) 	Trả thù. 
Rŭ mdơ̆ng (đgt)	Xây dựng. Ru\ mdơ\ng pưk sang: Xây dựng nhà cửa.
Rŭng	I. (tt)  rối
	Ii. (dt) sang ru\ng: nhà bỏ hoang.
Rŭng răng (tt)	Rối ren. Yang [uôn ru\ng răng: Xã hội rối ren.
Rưng (tt)	Thưa. Eùgei rưng: Răng thưa.
Rưng ƀhưng (tt)	Thưa thớt. Pưk sang rưng [hưng: Nhà cửa thưa thớt.
	 
S	 
	 
Sa (dt)	Mrô sa: Số một. Knăm sa
Sa ai (tt)	Một lòng
Sa ƀai (dt)	Cái dũa.
Sa hnơ̆ng mĭn (tt)	Nhất trí.
Sač 	I. (dt) ana sa]: cây dâu da; boh sa]: quả dâu da.
	Ii. (đgt) sa] êa: tát nước; sa] yao: đánh băt cá.
Sah	I. (đgt) mài. Sah dho\ng: mài dao.
	Ii. (tt) nhạt
Sah brah (tt)	Rời rạc.
Sai (đgt)	Rải. 
Sai êa mah (đgt)	Thếp vàng.
S’aĭ (pht)	Đều
Sak (đgt)	Keôo. Sak [ăng bhă: Keôo cửa; Sak klei sak: Keôo dây keôo (Pheôc mơ tuya).
Sang (dt)	1. Nhà. Sang tlô: Nhà vệ sinh.
	2. Rạp. Sang mdah rup: Rạp chiếu bóng.
	3. Chùa. Sang yơng: Chùa.
	4. Tháp. Sang tuôr: Tháp.
Sang aê diê (dt)	Nhà thờ.
Sang dăng kông (dt)	Bưu điện.
Sang dhar kreh (dt)	Nhà Văn hí.
Sang êa drao (dt)	Bệnh viện.
Sang kahan (dt) 	Trại lính.
Sang kưt mmuiñ (dt)	Rạp hát.
Sal đrao (dt)	Lưỡi nứa săc (beôn).
Sar (dt)	1. Sar kyâo: Lõi cây. 
	2. Sar boh kruê: Cuộn sợi; Sar kruê: Mũi quay
Să 	I. (dt) (yu) xã. Să }ư\ eùbur: xã }ư\ eùbur.
	Ii. (đt) đan. Ama kâo să yûuăl: bố tôi đan lưới; să wông êman: buộc bành voi.
Săl (đgt)	Nheôt chặt. Săl ktơr hlăm klu\ng: Nheôt chặt băp vào bao.
Săl wăl (tt)	Chập choạng. Mmăt săl wăl: Chập choạng tối.
Săm dah (pht)	Tuy nhiên.
Săm dêč (dt)	Ana săm dê]: Cây săm dê].
Săm muôr (dt) 	Giê săm muôr: Cây chọc lỗ tỉa luôa.
Săn (dt)	Cây hương. Kyâo săn: Gỗ hương.
Săn asei mlei (đgt)	Hy sinh.
Săng (đgt)	Hiểu. Ih thâo săng mơ\?: Anh có hiểu không?
Săng đai (dt)	Dây xích. Mă klei săng đai kă asâo: Lấy dây xích buộc chó.
Săp 	I. (dt) khói. Săp pui: khói lửa.
	Ii. (đgt) che
Săt (đgt)	1. Veôn. Săt m’iêng kơ dlông [iă: Veôn váy cao một tí.
	2. Teôm. Săt [u\k bi siam: Teôm tóc cho đẹp.
	3. Căt
Sbah (đgt)	Lăn đùng. Le\ buh sbah: Ngã lăn đùng.
Sdăk sdai 	Ngả rạ. Mnuih djiê sdăk sdai: Người chết như ngả rạ.
Seh (đgt)	Thảy
Seh soh (tt)	Sai sót. Kâo ngă seh soh leh: Tôi làm sai sót rồi.
Sgŏng (dt)	Giây. Sa mnyøt mâo năm pluh sgo\ng (1 phuôt = 60 giây).
Si, si ngă (đt)	Thế nào.
Si ke (dt)	Xeã ke.
Si măng (dt) (Pr)	Xi măng.
Si tô hmô (dt)	Ví dụ.
Siam (tt)	Đẹp. Mnga anei siam snăk: bông hoa này rất đẹp.
Siam sĭn (tt)	Đẹp đẽ. 
Siam siăn (tt)	Chẳng đẹp.
Siap (dt)	Cánh. Mlâo siap ]yøm: Lông cánh chim; }yøm phiơr ho\ng siap: Chim bay băôûng cánh.
Siă (đgt)	Sát. Kkui siă lăn: Cuôi sát đất.
Siăp 	I. (dt) con trai (ngao).
	Ii. (tt) luôt. Klu\n siăp: ngập luôt.
Siêk (đgt)	Tách ra. Siêk đue# mdhê: Tách ra riêng.
Siêng (đgt)	Neôm. Siêng jam phiơr: Neôm dĩa bay.
Siêt 	I. (tt) híp. Ală siêt: măt híp. 
	Ii. (đgt) buộc. Siêt bu\ng ho\ng hwiê: buộc gùi băôûng mây.
Sim (đgt)	Chêm. Ama kâo sim kgă: Bố tôi chêm xà gạc.
Sin (dt)	Ngan. Sang kâo rông tlâo drei sin: Nhà tôi nuôi ba con ngan.
Sip sap (tt)	Cẩu thả. Mă bruă sip sap: Làm việc cẩu thả.
Sir (tt)	1. Kín. Găm bi sir: đậy cho kín.
	2. Liền. Anôk êka sir leh: Vết thương đã liền.
Siu (dt)	1. Cây trong bộ khung cửi dệt thổ cẩm.
Sĭ (đgt)	1. Lẹm. Lam syø: Dao lam lẹm.
	2. Khía. Dho\ng syø: Dao khía.
Sĭk (dt) (Pr)	1. Đường. Kbâo pioh ngă syøk: Mía để làm đường. 
	2. Rơ\k syøk: Cỏ may.
	3. Kbhoh syøk: Nhiều bọt.
Sĭn kŏ (đgt)	Chóng mặt.(chíng váng)
Sĭng (dt)	Aê syøng: Sư tử (cách gọi sư tử trong truyện cổ tích).
Sĭr (tt)	(Nhanh) Thoăt. Syør kơ anei syør kơ adih: Thoăt bên này thoăt bên kia.
Sĭt (pht)	Thật.
Sĭt dah (pt) 	Chăc răôûng.
Sĭt êmĭt (tt)	Thật chính xác
Sĭt nik (tt)	Chăc chăn.
Sĭt suôr (tt)	Chân thành.
Smŭk (dt)	Ana smu\k: Cây tai ngheô.
Snăk (pht)	Rất.
Snăk s’ưn (pht)	Rất nhiều.
Snăn (đt)	Như thế đó
Snei (đt)	Thế này. 
Soh (tt)	Sai. Klei soh: Lỗi.
Sŏng (dt)	1. So\ng abăn: đường may nối giữa hai tấm của một cái chăn thổ cẩm. 
	2. Uyõn so\ng: Heo nhỡ.
Sô 	I. (dt) (yuăn) cái xô. Sô mgơ\ng êa: xô đựng nước.
	Ii. (tt) cũ. Eùdeh sô: xe cũ.
Sô siă (tt)	Cũ kĩ
Sôč klei (đgt)	Tuột ra.
Sôk 	I. (dt) nhau thai
	Ii. (đgt) thụi (băôûng cây). Sôk ti ro\ng: thụi vào lưng.
Sông (đgt)	Kể lể công cán
Sô̆	I. (đgt) đụng
	Ii. (đgt) truông phong.
Sơ lĭp (dt) (Prăng)	Quần lót.
Sơh (pht)	Từ dùng để đuổi chim
Sơ̆k (dt)	Cái gùi nhỏ. Djă ti sơ\k
Sơ̆ng (đgt)	1. Đong. Sơ\ng braih: đong gạo.
	2. Lia
Srai (đgt)	Vãi
Sră (đgt)	Phóng. Sră kju: Phóng lao.
Srăng (pht)	Sẽ.
Srêñ (dt)	Thầu dầu. Ana srêyû: Cây thầu dầu; Boh srêyû: Quả thầu dầu.
Sruah sruah 	Không có. Nao kơ anei sruah
Sruê (dt)	Sởi. Hđeh m[le\ sruê: Beô lên (mọc) sởi.
Srŭp (đgt)	Luôt. Klu\n sru\p hlăm êa: Ngập luôt dưới nước.
Su (dt)	Pra su: Giàn su su; Boh su: Quả su su.
Sua (đgt)	Lấy lại
Sua mă (đgt)	Chiếm lấy.
Sua wĭt (đgt)	Giành lại.
Suah (dt)	Sậy. Rơ\k suah: Cỏ sậy.
Suai	I. (dt) ana suai: cây xịi; boh suai: quả xịi.
	Ii. (đgt) lấy ra
Suai săk (đgt)	Lục lọi. Suai săk mnơ\ng mnuă: Lục lọi đồ đạc.
Suaih (tt)	Khoẻ. Ih suaih asei mlei mơ\?: Anh có khoẻ không?
Suaih pral (tt) 	Khoẻ mạnh. Aáu suaih pral na nao: Nó luôn luôn khoẻ mạnh.
Suan (dt)	Vàng tây. Kông suan: Vòng băôûng vàng tây.
Suă (đgt)	Giãn. Suă awăt ariêng: Giãn gân cốt. 
Suăi (tt)	Vất vả. Mă bruă suăi: Làm việc vất vả. 
Suăi ñam (tt)	Cực nhọc. Mă bruă suăi yûam: Làm việc cực nhọc.
Suăl (tt)	Lầm. Kâo suăl yûu ho\ng pô mkăn: Tôi lầm nó với người khác.
Suăng (đgt)	Vứt đi.
Suăp (đgt)	Xục vào. Mu\t suăp hlăm sang: Xục vào trong nhà.
Suăr (tt)	Tỉnh táo
Suăt suang (đgt)	Xục xạo. Hiu suăt suang hlăm kmrơ\ng: Xục xạo trong rừng.
Suê 	I. (dt) cái lờ
	Ii. (đgt) soi lỗ. Suê [ăng lir: soi lỗ (hang) dế trũi.
	Iii. Mới trổ còn non. Ana boh suê diê: quả mới nhuô còn non.
Suê bruê (tt)	Lẻ tẻ. Mnuih hriê suê bruê: Người đến lẻ tẻ. 
Suêñ 	I. (đgt) bện. Suêyû klei ku\i: bện dây thừng.
	Ii. (tt) đẹp. {o# mta suêyû: mặt mũi đẹp.
Suê̆ (đgt)	1. Nhổ. Sue# msei kđyøn: Nhổ đinh.
	2. Ruôt. Sue# đao gưm: Ruôt kiếm.
Suh sah (tt)	Hùng dũng
Sui sĭn (tt)	Lâu lăc.
Sui sĭt sui sĭn (tt)	Lâu lăc lâu lơ.
Sul (đgt)	Xới. Sul mbuôn djam: Xới luống rau.
Sun (đgt)	Lót. Sun ktat kơ mnu\: Lót ổ cho gà; Sun dôk: Lót ngồi.
Suôn (dt)	Vạt tranh cũ
Suôp (tt)	Xốp. Boh krue# suôp: Quả cam bị xốp.
Suôr	I. (dt) vỏ
	Ii. (tt) giáp liền
Suôt (đgt)	Đuổi. Suôt wyøt kơ sang: đuổi về nhà.
Suôt sông (đgt)	Xua đuổi.
Sur êwa (đgt)	Thở.
Sut	I. (dt) mnal sut: giẻ lau.
	Ii. (đgt) lau
Sut dhông (đgt) 	Lau chùi.
Sŭk (dt)	Klang su\k: Xương sườn.
Sŭk suôr (tt) 	Chân thành. Ai tiê su\k suôr: Lòng chân thành.
Sŭl (tt)	Tốt quá mức. Mdiê su\l: Luôa tốt quá mức.
Sŭm (đgt) 	Vùi. Su\m rơ\k: Vùi cỏ. 
Sŭm klŭm (đgt)	Vùi lấp.
Sŭn (đgt)	Chồng lên nhau. Su\n ]hiên: Chồng cheôn lên nhau.
Sŭp (dt)	Phở. {ơ\ng su\p: aûn phở.
Sŭr (đgt)	Vượt qua. Eùdeh blă su\r: Xe vượt qua (rất nhanh).
Sŭt (dt)	Hluăt su\t: Sâu róm.
Sưh (đgt)	Đuổi. 
Sưh đuê̆	Đuổi đi khỏi.
Sưk (đgt)	Xước. Mnal sưk: Vải bị xước. 
Sưk sak (đgt) 	Xây xước.
Sưp (dt)	Ana sưp: Cây chôm chôm; Boh sưp: Quả chôm chôm.
Sư̆ (đgt)	Xê ra. Sư\ kơ adih: Xê ra bên kia.
    	 
T	 
	 
Ta ală (dt)	Chột măt 
Tač (dt) 	Bãi. Ta] rơ\k: Bãi cỏ. 
Tač êngao (dt) 	Bên ngịi.
Tah (đgt) 	Dỡ
Tai (tt) 	Chùng. 
Tai tăk (tt)	Chùng cheãnh.
Taih (đgt) 	Xa. {uôn taih raih kbưi: Quê hương xa xôi (vời).
Taih tĭn (tt) 	Xa tít. Eùlan klông taih tyøn: đường sá xa tít.
Taih kbưi (tt) 	Xa xôi. Kryøng [uôn sang taih kbưi: Vùng xa xôi (vùng sâu vùng xa).
Tak (đgt)	1. Bôi. Tak êa [lyøt: Bôi hồ dán.
	2. Chấm. Tak êa ju\: Chấm mực.
Tak hrak (đgt) 	Trươyùt ngã. Tak hrak jơ\ng le\ buh: Trượt chân ngã.
Tak mia (đgt) 	Bôi trát.
Tal 	I. (đgt) xẻo. Ama kâo tal ]yøm êmô: bố tôi xẻo thịt bò.
	Ii.(dt) 1. Thứ vị. Sang tal dua: nhà thứ hai. 
	2. Tầng. Sang dua tal: Nhà hai tầng.
Tal êlâo (dt)	Trước tiên
Tam (đgt)	1. Đầm (ngâm). Kbao tam hlăm êa: Trâu đầm dưới nước.
	2. Đặt (ngâm dưới nước). Tam hrôk: đặt lờ.
Tang (dt) 	Ana tang: Cây xoan.
Tao (dt) 	Hbei tao: Khoai lang.
Tao wao (dt) 	}yøm tao wao: Chim tao wao.
Tap (đgt) 	Lót. Tap mnal: Lót vải; Tap hla: Lót lá.
Tar (tt) 	Khăp. Aáu đue# hiu tar  [uôn sang: Nó đi khăp [uôn làng.
Tar ƀar (tt) 	Khăp mọi nơi
Tat (đgt) 	Neôm mạnh xuống đất. 
Tă (đgt) 	1. Xẻ. Ayo\ng kâo tă ]yøm u\n: Anh tôi xẻ thịt heo.
	2. Phát (cỏ). Ama kâo tă guê lo\: Bố tôi phát bờ ruộng.
	3. Căt may. Amai kâo tă ao: Chị tôi căt áo.
Tă tăn (tt) 	Bậy bạ. Mă bruă tă tăn: Làm việc bậy bạ.
Tăk (đgt) 	1. Bật. Tăk pui: Bật đèn.
	2. Lẩy. Tăk mne#] phao: Lẩy cò suông.
Tăk ƀlăk (dt)	Long cong (Làm băôûng tre để đuổi thuô).
Tăk la (dt) 	Con dán.
Tăk lê lô (dt) 	Con răn mối.( con thăôûn lăôûn)
Tăk lu (dt) 	Con giời.
Tăk mnâo (đgt)	Nấc cụt. Aáu [le\ tăk mnâo: Nó bị nấc cụt.
Tăk ta (dt) 	Đyøng tăk ta: Kèn tak ta.
Tăk tai (đgt) 	Đu đưa. Dôk gu\ tăk tai jơ\ng: ngồi đu đưa chân.
Tăm (đgt) 	1. Lợp. }uôr sang tăm ho\ng hlang: Mái nhà lợp băôûng tranh.
	2. Đuổi. Tăm mnu\. Đuổi gà.
	3. Lỡ
Tăm ênua (đgt) 	Đền mạng. 
Tăm pah (đgt)ì	Nguyền rủa.
Tăn (đgt) 	Làm cố. Tăn kơ bruă: Cố làm việc.
Tăng (đgt) 	Cãi. Anak tăng ho\ng amyø ama: Con cãi cha mẹ.
Tăng mgăl (đgt) 	Cãi cọ. Mnuih khăng tăng mgăl: Người hay cãi cọ.
Tăng hik (dt) 	Con bọ xanh.
Tăng măng (dt) 	Con chuồn chuồn. 
Tăng tĭt (dt) 	Con bướm.
Tăp (đgt) 	Giã (luôa). Amai kâo tăp mdiê: Chị tôi giã luôa.
Tăp năng (pht) 	Thỉnh thoảng.
Tâo (dt) 	Boh tâo: Cục đá; Boh tâo lăng đá cuội.
Teh (đgt) 	Đánh. Teh ko\ mnu\: đánh đầu gà.
Tei (dt) 	Kan tei: Cá tra.
Tei hŭng (dt) 	Đu đủ. Boh tei hu\ng: qủa đu đủ; ana tei hu\ng: cây đu đủ.
Tei čik, tei nan (dt)	Dứa (thơm). Boh tei ]ik: Qủa dứa.
Teng teng (tt) 	Keng keng.
Tĕng tŏng (tt) 	Đầy. Tian buk te\ng to\ng: bụng đầy hơi.
Tê (dt) 	Djam tê: Canh nấu với bột gạo.
Têč hnêč (đgt) 	Vấp. Adei kâo tê] hnê] le\ buh: Em tôi vấp ngã.
Têñ (tt) 	Chậm. Mă bruă têyû êgao năng: Làm việc quá chậm.
Têñ ƀêñ (tt) 	Chậm reã. 
Tha (đgt) 	Thả.
Thak (tt) 	Trề ra. K[uê thak: Môi trề.
Thar (đgt) 	Lo liệu. Pô thar bruă mă: Người lo liệu công việc.
Tham (đgt) 	Cuông hiến sinh để từ bỏ mảnh đất.
Thao (dt)	1. Thiếc. Knuah êa ngă ho\ng thao: Gáo nước làm băôûng thiếc.
	2. Thùng. Aáu pu\ thao êa: Nó bê thùng nước.
Thăt (dt) 	Ao thăt: Cái yếm.
Thâo 	I. (đgt) biết. La] kơ yûu thâo: nói cho nó biết.
	Ii. (tt) giỏi. Aáu hriăm thâo snăk: nó học rất giỏi.
Thâo đup gưt (tt)	Lễ pheôp.
Thâo jum tue êgar (tt)	Hiếu khách.
Thâo klă 	Hiểu rõ.
Thâo knal (tt)	Lịch thiệp.
Thâo krăl (đgt) 	Quen biết.
Thâo răng (tt)	Cẩn thận.
Thâo săng (đgt) 	Hiểu.
Theh (đgt) 	Đánh. Theh ti kđiêng: đánh vào ngón tay.
Them (đgt) 	Thêm. Them bruă: thêm việc.
Thiăm (đgt) 	Thêm. Lo\ thiăm mnuih: Lại thêm người.
Thiê (đgt) 	Cho
Thiêl (đgt) 	Aûn từ từ
Thiêng (đgt) 	Phang. Thiêng ti ko\: Phang vào đầu.
Thiêp jông (dt) 	Cây chêm reãu.
Thiêp thiêp (tt) 	Thoảng qua. Angyøn thiêp thiêp: Gió thoảng qua.
Thiêr (dt) 	Con mối nhỏ.
Thik thôk (tt) 	Lười. Alah thik thôk: Lười chảy thây.
Thĭu (tt) 	Thiếu. Thyøu ênoh: Chưa đủ (thiếu số lượng).
Thơ (dt) 	Người mổ thịt. Aáu ngă thơ êmô: Nó làm (mổ) thịt bò.
Thơt (dt) 	Cái thớt.
Thu (tt) 	Khô. Lăn thu: đất khô.
Thung (dt) 	Ống chân
Thuôt (dt) 	Mụn cóc.
Thut (đgt) 	Thổi
Thŭn (dt) 	Năm
Thŭn kruôp (dt)	Năm nhuận.
Thŭng (dt)	Thùng. Thu\ng mdiê: Thùng luôa.
Thưp (đgt) 	Nhấm nháp. Thưp mnâo: Nhấm nháp mùi vị (hương vị);
	Thưp mnâo kphê: Nhấm nháp hương vị cà phê.
Thưt (đgt) 	1. Giống như thư\. 
	2. Nhỏ giọt.
Thưt thưt (đgt)  	Nhỏ giọt. Eùa k’ho\ thưt thưt: Mồ hôi nhỏ giọt.
Thư̆ 	I. (đgt) ngớt. Hjan amâo thư\: mưa không ngớt.
	Ii. (dt) giọt. Dua pluh bliư\ thư\: hai mươi giọt.
Ti (đt)	Đại từ chỉ nơi chốn. Ti anei: eûoù đây; ti krah: eûoù giữa.
Ti anôk (đt)	Eûoù đâu.
Ti djiêu (dt)	Bên cạnh.
Ti tluôn (dt)	Đăôûng sau.
Tia (đgt) 	Rèn. Tia kgă: Rèn xà gạc.
Tiăm tiăm (tt) 	Phàn nàn.
Tian (dt) 	Bụng. Eùpa tian: đói bụng; Ruă tian: đau bụng.
Tiăng (đgt) 	Tiăng tiăng (pht): Chan chát. Đo\k blu\ tiăng tiăng: Giọng nói chan chát (nói săôïng và mạnh).
Tiap (đgt) 	Lót.
Tiăr tiăr (tt) 	Khanh khách (Vật cứng va chạm vào nhau tạo ra âm thanh). 
Tiê (dt) 	Gan. Tiê êmô: Gan bò.
Tiê boh (dt) 	Tim
Tiêng (dt) 	1. Mụn nhọt.  
	2. Hbei tiêng. Củ beãnh tinh.
Tiêng liêng (dt) 	Chuông.
Tiêo (đgt) 	Giăt. Tiêo ti k’iêng: Giăt bên hông.
Tiêp (tt)  	Nhói.
Tiêp tiêp (tt) 	Nhoi nhói (đau nhoi nhói). Hdăm ke\ ruă tiêp tiêp: Kiến căn đau nhoi nhói. 
Tiêr (đgt) 	Đi vòng quanh. Tiêr hma: đi vòng quanh róy. 
Tiêt 	I. (đgt) cài. Tiêt hăt ti knga: cài (giăt) thuốc trên vành tai.
	Ii. (dt) boh tiêt: hạch.
Tiêu (đgt) 	Giống như tiêo.
Tih 	I. (dt) boh tih: băp chân.
	Ii. (đgt) đào hố sâu. Tih hbei dliê: đào củ mài.
Tin (dt) 	Hbei tin: Củ đậu.
Tin tun (tt) 	Tròn lẳn. Asei mlei tin tun: Người mập (thân heãnh tròn lẳn).
Ting (đgt) 	Cập bến
Tiŏ (đgt) 	Đuổi (theo).
Tiŏ nao (đgt) 	Phái đi. Amyø ama tio\ nao dăm dei êmuh ung kơ anak mniê: Cha mẹ phái anh em trai (của mẹ) đi hỏi chồng cho con gái.
Tiông (dt) 	Lóy nỏ
Tit (dt) (yu) 	Tết. {ơ\ng tit: aûn tết.
Tir (đgt) 	Giống như tiêr.
Tĭ (tt) 	Rách. Ao tyø: Aoûo rách.
Tĭ rư̆č (tt) 	Rách tả tơi. }hum ao tyø rư]: Quần áo rách tả tơi.
Tĭ tŭl (tt) 	Rách rưới.
Tĭk tăk (tt) 	Tích tăc.
Tĭk (dt) 	Mủ tai.
Tĭm ahĭm (đgt) 	Không ưa thích. Ya ngă ih tyøm ahyøm nanao kơ gơ\?: Tại sao anh không ưa thích nó?.
Tĭm tŭm (tt) 	Sưng
Tĭng (dt) 	1. Tính. Klei tyøng: Pheôp tính.
	2. Phía
Tĭng grĭng (tt) 	Lảo đảo. Eùbat tyøng gryøng: đi lảo đảo.
Tĭp (đgt)	Tyøp djo\: Truông phóc.
Tĭr tĭr (tt) 	Aõuïm ầm. Grăm kmlă tyør tyør: sấm seôt ầm ầm.
Tla (đgt) 	Trả. Tla nư: Trả nợ.
Tlah (đgt) 	Bẻ ra
Tlaih (đgt) 	1. Thít. Bi tlaih mnu\: Làm xổng gà.
	2. Khỏi. Tlaih  ư\ êpa: Khỏi đói keôm.
Tlak (đgt) 	Rẽ. Tlak êlan tâo: Rẽ ngôi tóc.
Tlam (dt) 	Chiều. Mơ\ng aguah truh kơ Tlam: Từ sáng đến chiều.
Tlam êngam (dt) 	Chiều chiều.Tlam êngam ]yøm khăng phiơr wyøt kơ hruh: Chiều chiều chim thường bay về tổ.
Tlan (dt) 	Vi khuẩn.
Tlang (dt) 	Diều hâu.
Tlang hiă (dt) 	Chim ó.
Tlao (đgt) 	Cười. Tlao  [u\YÛ: Cười mỉm; Tlao djik: Cười mỉa.
Tlar (tt) 	Láng. Eùlan tlar: đường láng (nhiều người đi lại).
Tlă (đgt) 	Phả vào. Angyøn tlă  [o#: Gió phả vào mặt.
Tlăk tlăr (tt)	Ba lăng nhăng. Mnuih tlăk tlăr: Người ba lăng nhăng.
Tlăl (đgt) 	Bịch. Tlăl le\ buh: Teô bịch.
Tlăm (đgt) 	Che lấp.
Tlăn (dt) 	Con trăn.
Tlăng (đgt) 	Cuốc (đào) (lật). Tlăng  hbei tao: đào khoai lang.
Tlăp (tt) 	Cũ. Ao tlăp: Aoûo cũ.
Tlăp mlăp (tt) 	Cũ kyoä. Aáu ]u\t ]hum ao tlăp mlăp: Nó mặc quần áo cũ kyoä.
Tlăt (đgt) 	Nhảy phóc. Tlăt đue# hiu: Nhảy phóc đi chơi.
Tlâo (dt) 	Ba. Mrô tlâo: Số ba.
Tleh tloh (tt) 	Bầy nhầy. }yøm tleh tloh: Thịt bầy nhầy.
Tlĕ (đgt)	Aûn căp.
Tlê (đgt) 	Giã. Tlê amrê]: Giã ớt.
Tli (đgt) 	Trát. Tli lu\: Trát bùn.
Tli tlia (tt) 	Lạch bạch. Eùbat tli tlia: đi lạch bạch.
Tliăl (tt) 	Thua. Ngă tliăl  amâo dưi: Thua không làm được.
Tliă tliêt (tt) 	1.Tỉ mỉ. Mă bruă tliă tliêt: Làm việc tỉ mỉ.
	2. Sâu săc. 
Tliêng (dt) 	Cài gùi lớn có năp đậy để đựng quần áo.
Tliêp (tt) 	Bất ngờ. 
Tliêr (tt) 	Cẩn thận
Tliêt (tt) 	Nhão. Eùsei tliêt: Cơm nhão.
Tlin (dt) 	Vô sinh (động vật). Uyõn tlin: Heo sổi (Quôa mập không đẻ được).
Tling (đgt) 	Buộc. Tling êman ti phu\n kyâo: Buộc voi ở gốc cây.
Tlip	Dính. 
Tlit (tt) 	Đặc. Bur tlit: cháo đặc.
Tlit tlat (tt) 	Đặc quánh.
Tlĭr (đgt) 	Thoăt. Tlyør kơ anei tlyør kơ adih: Thoăt ở đây thoăt ở bên kia.
Tloh ( đgt) 	Đứt. Tloh blei: mua đứt (được).
Tlŏ (đgt)	1. Tiêm. Tlo\ êa drao: Tiêm thuốc. 
	2. Đâm. Tlo\ kbao: đâm trâu.
Tlŏng (dt) 	Eh tlo\ng: Ráy tai.
Tlŏng tlut (dt) 	Cái gáy (phần sau của đầu).
Tlơ tlêč (tt) 	Lấp lánh. Buê mah tlơ tlê]: Bông tai lấp lánh.
Tlơ̆ng (đgt) 	Đổ
Tlô 	I. (đgt) đi ngịi
	Ii. (dt) dliê tlô: phong cảnh.
Tlu (dt) 	Dương vật.
Tlua (đgt) 	Tưới
Tluh (đgt) 	Thèm. Tluh mhao: Thèm khát.
Tlun (đgt) 	Giăt (ở dưới). Tlun mu\ng: Giăt màn.
Tlung (dt) 	Dốc thoai thoải.
Tluñ (đgt)	Phỉnh.
Tluôn (dt) 	1. Boh tluôn: Mông 
	2. Ti tluôn: Phía sau.
Tluôr (dt) 	Cá chạch.
Tlŭk tlăk (đgt) 	Chao động.
Tlŭm (đgt) 	Phủ (che phủ). {u\k tlu\m ală: Tóc che phủ măt.
Tlŭn (dt) 	Con nòng nọc.
Tlŭng (dt) 	Vết sẹo sâu (sau khi đã khỏi).
Tlŭp (tt) 	Cụp. Asâo tlu\p knga: Chó cụp tai.
Tlư (dt) 	Hbei tlư: Củ ráy.
Tlưč (dt) 	Hrah tlư]: đỏ hồng (màu hồng).
Tlưh (đgt) 	Xẻ. Tlưh ]ư\: Xẻ nuôi.
Tlưng ( đgt) 	Hất
Tlưng tlang (đgt) 	Quật (mạnh) eùman tlưng tlang phu\n alê: Voi quật bụi tre.
Tlưt (đgt) 	Nhót
Toh (đgt) 	Cởi ra. Tloh klei mah ti kkuê: Cởi dây chuyền ra khỏi cổ.
Ton (dt) 	Tấn (1tấn = 1000 kg).
Tŏ (dt) 	Cái lọ. To\ mnga: Lọ hoa.
Tŏk (dt) 	Cái gùi (vùng êa Hleo).
Tŏk bŏk (dt) 	Boh to\k bo\k. (1 loại quả trong rừng giống quả sung nhưng không ăn được).
Tŏng bi (dt) 	Mnga to\ng bi: Hoa beãm bịp.(hoa beãm beãm)
Tô (dt) 	Bạn gái.
Tô hmô (dt)	Ví dụ.
Tô rô (dt) 	Ana tô rô: Cây keo; Boh tô rô: Cây keo.
Tôč (đgt) 	Rỉa. Kan tô] mnơ\ng: Cá rỉa mồi.
Tôk (dt) 	Cái vỏ.
Tôl (dt) 	Tôn.
Tông 	I. (đgt) gõ (đánh). Tông ]ing: đánh chiêng.
	Ii. (dt) tông: u (thịt). Bi tông: cục u thịt; ana tông: cây cói dùng để dệt chiếu.
Tông lông(dt) 	Cây thần thoại ở trên mặt trăng giống như cây đa trên mặt trăng theo như huyền thoại của người Kinh.
Tô̆ng đơ (dt) 	Cái tông đơ căt tóc.
Tơ, tơ dah (pht) 	Nếu
Tơl (pht) 	Thậm chí
Tơ̆ng (đgt) 	Eùa tơ\ng: đoạn suối sâu.
Tơr bŭng (dt) 	Chân gùi.
Tra (dt) 	Aguah tra (ngày thứ ba kể từ sau ngày hôm nay).
Trač (đgt) 	Xịt. Tra] êa: Xịt nước.
Trah trač (tt) 	Đoảng. Mă bruă trah tra]: làm việc đoảng (không kyoä).
Trah (đgt) 	Trah jal: Quăng chài; Trah dlăng: Nheãn xa.
Trah dlăng (dt) 	Thăm nom
Trah mdrao (đgt) 	Chăm nom thuốc thang
Traih (đgt) 	Chải (chỉ).
Traih mrai (đgt) 	Chải chỉ băôûng bàn chải.
Trak trak (đgt) 	Ròng ròng. Eùa [le\ trak trak: Nước chảy ròng ròng.
Tram (đgt) 	Ngâm.Tram phyø kgâo ho\ng kpiê: Ngâm mật gấu với rượu.
Trang (dt) 	Cỏ lau.
Trañ (dt) 	Trayû bu\ng: đáy gùi.
Trao (dt) 	Vòng số 8 (băôûng dây rừng) dùng để cùm hai chân trước của voi.
Trap (tt) 	Không đủ. Amâo trap mnơ\ng [ơ\ng: Không đủ thức ăn.
Trap trap (tt)	Sâm sấp. Dưm êa trap trap: để nước sâm sấp.
Trăn (dt)	Bông trăn: Aoûo quan (hòm) bên ngịi.
Trăp(dt) 	Đầm lầy.
Trăp čuôr (dt) 	Cánh đồng
Trăp trang (dt) 	(Bãi đầm) Lau sậy
Treh 	I. (đgt) gạch. Treh anăn: gạch tên.
	Ii. (đgt) kẻ. Treh êlan kpă: kẻ đường thẳng.
Trei (tt) 	No. Huă bi trei: aûn cơm cho no.
Trei mđao(tt) 	No ấm.
Treng (dt) (Prăng)	Eùdeh treng: Xe lửa
Trĕ (đgt) 	Rỏ
Tri tria (tt) 	Xòe rộng ra. {ar m’iêng tri tria: Mặc váy xòe.
Tria (dt) 	Sàn. Tria riap ho\ng kram: Sàn lát băôûng tre.
Triă (dt) 	Ana triă: Cây triă (họ băôûng lăng).
Triăm (dt) 	Abăn triăm: Chăn thổ cẩm có 4 đường hoa văn đỏ.
Triah 	1. (dt) Mtu\ triah: Sao hôm. 
	2. Kan triah: Cá cheôp.
Triăng (đgt) 	Soi. 
Triêk (tt) 	1. Chẻ. Triêk alê: Chẻ tre.
	2. Msăm triêk: Chua loeôt; Kpiê msăm triêk: Rượu chua loeôt.
Triêl (đgt) 	Xeôn
Triêt (dt) 	Aguah triêt: Ngày thứ tư (sau ngày hôm nay).
Trih (đgt) 	Ghen.
Trih dah (đgt) 	Ghen tuông.
Tring ahing (tt) 	Trùng điệp.
Trĭ trŭ (tt) 	Nặng nề. Eùmo\ng đei êbat tryø tru\: Quá mập đi nặng nề.
Trĭt trĭt (đgt) 	Từng tí một. Brei prăk tryøt tryøt: đưa tiền từng tí một.
Trĭng (dt) 	Nám
Trĭp (tt) 	Vừa vặn.
Tro wêč (dt)	}yøm tro wê]: Chim tro wê].
Troh 	I. (dt) vực
	Ii. (đgt) đào băôûng vật nhọn (xà beng
Troh trôk (dt) 	Thung lũng.
Trŏk (đgt) 	Đầy ách. Bo\ tian tro\k. Đầy ách bụng.
Trŏng (dt) 	Cà. Tro\ng phyø: Cà đăng; Tro\ng lao: Cà rí; Tro\ng lue: Cà lông.
Trŏng drun (dt) 	Quả cà chua (nhỏ băôûng ngón tay).
Trŏng msăm (dt) 	Cà chua.
Trô (đgt) 	Rót vào chai. Trô  kpiê hlăm giêt: Rót rượu vào chai.
Trôč (đgt) 	1. Nhỏ giọt. Trô] êa ti ko\: Nhỏ nước lên đầu. 
	2. Cuông (con vật). Trô] êman: Cuông voi.
Trôč mia(đgt) 	Nhỏ và bôi. Trô] êrah ti ]eh: Nhỏ và bôi huyết vào cheô.
Trông (đgt)	Để
Trông čhai (đgt) 	Bàn bạc
Trông kdrông (đgt) 	Băc cầu khỉ.
Trô̆(đgt) 	Sực nức.
Trơ̆ng (đgt) 	Beôn. Pui trơ\ng: Lửa beôn.
Truang ahuang (tt) 	Sáng choang. Pui diăn truang ahuang: Ngọn nến sáng choang.
Truă (đgt) 	1. Đậy. Truă kdruă: đậy năp.
	2. Đeo. Truă ală kyøng: đeo măt kiếng.
Truă rup (đgt)	Đội lốt.
Truăk (đgt) 	Eõaüc. Lun truăk mtam: nuốt ực luôn.
Truăn (đgt) 	Chuyên tâm. Aáu truăn nanao kơ bruă: Nó luôn luôn chuyên tâm đến công việc.
Truăn mĭn (tt)	Lo lăng.
Truêč truêč (tt) 	Æt
Truh (đgt) 	Đến
Truih 	1. (đgt) Truih pui: Dập lửa.
	2. {âo truih: Hôi chua.
Truih traih (tt) 	Mùi thối.
Truk truk (tt) 	Aòo ạt. Hjan truk truk: Mưa ào ạt.
Truk trak (tt) 	Eøuïng ộc. Eùa [le\ truk trak: nước chảy ồng ộc.
Trul tral (tt) 	Nặng nề. Asei mlei trul tral: Thân heãnh nặng nề.
Trung (đgt) 	Phủ phục. Eùman trung: Voi phủ phục.
Truôl (dt) 	Eøöûi. Ana truôl: cây ổi; boh truôl: qủa ổi.
Truôl jang (dt) 	Ana truôl jang: Cây băôûng lăng hoa tím.
Truôm (dt) 	Con nhộng. Hluăt truôm: Sâu nhộng.
Trŭn (đgt) 	Xuống. Tru\n ]ư\: Xuống dốc.
Trŭt (đgt) 	Đẩy. Tru\t giê: đẩy gậy.
Trưng 	I.(dt) lán. Ngă trưng: làm lán.
	Ii. (đgt) quyoå xuống. Eùman trưng: voi quyoå xuống.
Tu (dt) 	Cái mai
Tu krua (dt) 	Mai rùa. Tu krua khăng snăk: Mai rùa rất cứng.
Tuah (đgt) 	Muôc. Tuah êa: Muôc nước.
Tuai (dt) 	Pưk tuai: Chòi tạm.
Tual (đgt) 	Khoanh (tròn).
Tual wĭl (dt) 	Khoanh tròn. Giê tual wyøl: Com pa.
Tuang (đgt) 	Chăng. Wăk wai tuang hruh: Con nhện chăng tơ.
Tuăk (đgt) 	Móc
Tuăng tuăng (đgt)	Đùng đùng. Eùnai phao tuăng tuăng: tiếng suông đùng đùng.
Tuăp (đgt) 	Truông phóc. Mnu\ ]oh tuăp: Gà mổ truông phóc.
Tuăr (đgt) 	Phập. Djo\ tuăr ti ko\: Truông phập vào đầu.
Tuăt tuăt (tt)	Loăt choăt.
Tuč (đgt) 	Châm. Tu] pui: Châm lửa.
Tue, tuê (dt) 	Khách.
Tue hiu čhưn (dt) 	Khách du lịch.
Tuêh (đgt) 	Veôt. Tuêh go\ êsei: Veôt nồi cơm.
Tuh (đgt) 	Đổ
Tuh jia (đgt) 	Đóng thuế.
Tuh lăn(đgt) 	Cuông thần đất.
Tuh suôr (đgt) 	Lột da. Ala tuh suôr: Răn lột da.
Tui (đgt) 	Theo.
Tui čih (đgt) 	Cheôp
Tui duah (đgt) 	Teãm kiếm.
Tui hluê (đgt) 	Đi theo.
Tui kru (đgt) 	Đi theo dấu vết.
Tui si (đgt) 	Giống như. Ngă tui si yûu la]: Làm giống như nó nói.
Tuič (đgt) 	Kết thuôc.
Tuič ai (đgt) 	Tăt thở.
Tuič djuê (đgt) 	Tiệt nòi
Tuič ruê̆ (đgt)	Kết thuôc.
Tuit (đgt) 	Nheôo.
Tuĭ (đgt) 	Bịch. Le\ tuyø ti lăn: Rớt bịch xuống đất. 
Tuk (dt) 	Kmu\n tuk: Dưa gang; }eh tuk: Cheô tuk.
Tum (dt) 	Kyoå đà.
Tung (dt) 	Gian. Tung gah: Gian trước; Tung mniê: Gian giữa giành cho phụ nữ ngồi uống rượu nhà sàn Êđê.
Tuôm (đgt) 	Gặp. Bi tuôm: Gặp nhau.
Tuôm ƀô̆(đgt) 	Gặp mặt. Tuôm [o# so# ală: Mặt giáp mặt.
Tuôr 	I. (dt)1.ốc xoăn (vặn)
	2. Tháp. Sang tuôr: Tháp.
	3. Vòng
	Ii. (đgt) qua. Tuôr kdrông: qua cầu. 
Tut (dt) 	Cây tầm gửi.
Tur (dt) 	Nền. Tur sang: Nền nhà. 
Tur êa krông (dt) 	Đáy sông.
Tŭ ư (đgt) 	Công nhận
Tŭ dưn (tt) 	Æch lợi. Mnuih tu\ dưn: người có ích.
Tŭ jing (tt) 	Thành công.
Tŭč krŭč (tt) 	Khật khưỡng (khiễng). Eùbat tu\i] krui]: Bước đi khập khiễng. 
Tŭk (đgt) 	1. Nấu
	2. Đấm. Tu\k ti ro\ng: đấm vào lưng.
Tŭk riă(đgt) 	Ninh
Tŭk tŭl (tt) 	Mù mịt. {hu\l tu\k tu\l: Bụi mù mịt.
Tŭk mrui (dt) 	Con bọ nhỏ.
Tŭk mrŭk (dt) 	Đồ dùng để đuổi chim thuô.
Tŭl 	I. (đgt) huôc. Eùmô tu\l: bò huôc.
	Ii. (tt) xăôûng bậy. Blu\ tu\l: nói xăôûng bậy (không có đầu đuôi).
Tŭl tăl (tt) 	Chăc nịch. Asei mlei tu\l tăl: Thân heãnh chăc nịch.
Tŭm (tt) 	Phồng lên. Bo\k tu\m: Sưng phồng lên.
Tŭn (đgt) 	Aõaún. Tu\n bi kjăp: aõaún cho chăc.
Tŭn tăn (đgt) 	Aõaún chăc chăn.
Tŭng (dt) 	Rơ\k tu\ng: Cỏ gấu.
Tŭng klŭng (đgt) 	Lăn lóc.
Tŭp (tt) 	Phập.
Tŭr 	I. (dt) ana tu\r: cây bứa; boh tu\r: qủa bứa; mtu\ tu\r: sao mai.
	Ii. (đgt) đấm mạnh. 
Tŭt (dt) 	Đốt. Tu\t kđiêng kngan: đốt ngón tay; tu\t alê: đốt tre.
Tư hrư (tt) 	Thoai thoải. Tru\n dhu\ng (tlung) tư hrư: Xuống dốc thoai thoải.
Tưt (tt) 	Muộn. Bruă sui tưt: Việc lâu muộn (muộn màng).
Tưp (đgt) 	Lây
Tưp lar (tt) 	Lây lan. Klei ruă tưp lar djăp anôk: Bệnh lây lan khăp nơi.
Tư̆ (đgt) 	Nhích. Tư\ kơ dlông: Nhích lên trên.
Tư̆r tư̆r (đgt) 	Aõuïm ầm. Grăm kmlă tư\r tư\r: sấm seôt ầm ầm. 
	 
U	 
	 
U (tt) 	To lớn. Eùmô u: Bò giống to.
U u (đgt) 	Vù vù. Angyøn u u: Gió vù vù.
Ua jai (pht) 	Hơn
Uă (đgt) 	1. Rửa. Uă ]hiên mngan: Rửa cheôn bát.
	2. Cưa. Uă kyâo: Cưa gỗ.
	3. Keôo. Uă pui: Keôo bùi nhùi mồi lửa; Uă kni: Keôo nhị.
Uak (dt) 	Cái theãa. Uak boh: Cái muôi; Uak giê: đũa cả xới cơm.
Uan (dt) 	Giống như awan.
Uan dhuan (dt) 	Giống như awan dhuan: Thân heãnh.
Uăt (tt) 	Eõaüc. Lun uăt: nuốt ực.
Uăm (tt) 	Phù. Bo\k uăm: Sưng phù.
Uăm uăm (đgt) 	Oang oang. Đo\k blu\ uăm uăm: Giọng nói oang oang.
Uăr (tt) 	Sưng vù. Uăr  ko\ng đo\k: Họng sưng vù.
Uăr uăr (tt)	Sự ồn ào
Uăt (tt)	Yếu. Mnuih uăt: Người yếu.
Uê (dt) 	Màu nâu. Ju\ uê: đen nâu.
Uê pui (dt) 	Khói đọng lại
Uêñ (đgt) 	Quan tâm
Uêñ uêñ (tt) 	Nài nỉ
Uh uh (tt) 	Râm ran. Blu\ tlao uh uh: Cười nói râm ran.
Uh ưh (tt) 	Anh ách (đầy bụng khó chịu veã quá no).Tian trei uh ưh: Bụng no anh ách.
Uih (đgt) 	1. Uoùi (là). Uih ]hum ao: Uoùi quần áo. 
	2. Uốn: Uih [u\k: Uốn tóc. 
	3. Hơ. Uih  hla mtei: Hơ lá chuối.
Ung (dt) 	Chồng (vợ). Dôk ung: Lấy chồng.
Uôp (đgt) 	Bịt. Uôp [ăng êgei: Bịt miệng.
Uôt (đgt) 	Căt. Uôt êrah mnu\: Căt tiết gà.
Ur (đgt) 	Kêu
Ur lač (đgt) 	La to (nói to).
Ur hưn (đgt) 	La lối.
Ur mpŭ (đgt) 	Hoan hô.
Ut ut (tt) 	Theã thầm. Blu\ ut ut: Nói theã thầm.
U|k rŭk (đgt) 	Eõòng ực. Lun u\k ru\k: nuốt ừng ực.
U|k ŭk (tt) 	Đông đuôc. Mnuih u\k ăk: người đông đuôc.
Ul (đgt) 	}Uh ul: eûaë chua.
	 
U|	 
	 
U|l ăl (tt) 	Hầm hập. Hlơr u\l ăl: Nóng hầm hập.
U|n (dt) 	Lợn (heo). Eùđai u\n: Heo con; uyõn ana: Heo nái; uyõn dliê: Heo rừng.
U|ng (tt) 	Khum. Eù- i u\ng: Rổ khum (sâu).
U|r (tt) 	Mưng (mủ). Tiêng u\r ênah: Mụn nhọt mưng mủ.
U|r ŭr (tt) 	Eøuïn ào. Blu\ u\r ăr: nói ồn ào.
	 
Ư	 
	 
Ư (đgt) 	Vâng. Eõ djo\ ai: Vâng đuông rồi.
Ư ai ( đgt) 	Băôûng lòng.
Ưi ưi (tt) 	Aõm ỉ
Ưm (tt) 	Sớm. Nao ưm: đi sớm.
Ưm aguah (dt) 	Sáng sớm.
Ưm hĭn (dt) 	Sớm hơn.
Ưm hnưm (dt) 	Sớm lăm.
Ưm hrưm (dt) 	Còn quá sớm.
Ưm ôk (tt) 	Sớm tinh mơ. Aguah ưm ôk: Sáng tinh mơ.
Ưn (dt) 	Cái yên. Eõn êdeh: Yên xe.
Ưn đĭ aseh (dt) 	Yên ngựa.
Ưng ưng (tt) 	Hừng hực. Eùlah pui ưng ưng: Ngọn lửa hừng hực.
Ưr  ưr (tt) 	Rừng rực. Pui ưr ưr: Lửa rừng rực.
Ưt (đgt) 	Ngớt. Hjan amâo ưt: Mưa không ngớt.
Ưt ưt (đgt) 	Hừ hừ. Krao ưt ưt: Rên hừ hừ.
Ưp ap (tt) 	Aõaém thấp. Anôk ưp ap: nơi ẩm thấp.
	 
Ư|	 
	 
Ư| (đgt) 	Nhịn. Eõyõ êsei: Nhịn cơm.
Ư| êpa (tt) 	Đói keôm. 
Ư| êwa (đgt) 	Nín thở.
Ư| ăn (đgt) 	Nín
	 
W	 
	 
Wah 	I. (dt) lưỡi câu. Mnơ\ng ]u\t wah: mồi câu.
	Ii. (đgt) câu. Wah kan: câu cá.
Wah lač (đgt)	Cầu nguyện
Wah wơ	I. (tt) 1. Nghêu ngao. Mmuyû wah wơ dua tlâo prue# bi hlao ênguôt: hát nghêu ngao vài câu cho đỡ buồn. 
	2. Vất vưởng. Klei hdyøp wah wơ
	Ii. (đgt) quơ. Kngan wah wơ: quơ tay.
Wah wưt (đgt)	Phe phẩy. Wah wưt mnưh hlăm kngan: Phe phẩy chiếc quạt trong tay.
Wah yang (đgt)	Cuông thần.
Wai (đgt)	Đạp
Wai êdeh (đgt)	Đạp xe. Wai êdeh wai jơ\ng: đạp xe đạp.
Wai wưt	I. (tt) chệnh choạng (luôc ẩn luôc hiện). 
	Ii. (đgt) vụt. Mngăt mnuih wai wưt găn [ăng bhă: bóng người vụt qua cửa.
Wai tê (dt)	Ve sầu (ve tháng 3). 
Wai yut (dt)	Ve sầu (ve tháng 4).
Waih (đgt)	Chèo. Waih mran găn êa krông: Chèo thuyền qua sông.
Waih gai (đgt)	Chèo lái. Waih gai ktang giê kwa: Chèo lái mạnh mái chèo.
Wak wak (tt)	1. Tíng. Blu\ wak wak: Nói tíng lên; Dlao wa] wak wak: Chửi tíng lên.
	2. Eøuïn ào. Mnuih wak wak: Con người ồn ào. 
Wang 	I. (dt) 1. Quãng (đường)
	2. Khuôn khổ. Po\k ală kyøng ho\ng wang po\k rup: Tấm kính vừa khuôn khổ bức ảnh. 
	3. Eø. Wang [ăng bhă điêt: eø cửa sổ. 
	4. Nhịp. Kban dlông êma wang: Cầu dài năm nhịp. 
	5. Cột. Hră tyøng dăp mâo lu wang: Bảng thống kê có nhiều cột. 
	6. Vạt. Wang lăn pla djam: Vạt đất trồng rau.
	Ii. (đgt) 1. Vây
	2. Bủa. Jih jang mnuih wang hiu duah yûu: Mọi người bủa đi teãm nó.
Wang čuăn (dt)	Khuôn khổ. Bi mu\t mă pô hlăm wang ]uăn klei bhiăn: Tự gheôp meãnh vào khuôn khổ kyoã luật.
Wañ (đgt)	Nhăc đến.
Wao (dt)	Cái văôûng
Wao hla (dt)	Sáo diều.
Wao wao (tt)	Vi vu. Asăp wao hla wao wao: Tiếng sáo diều vi vu.
Wap wap (đgt)	Oai íi. Ur wap wap: La oai íi.
War (dt)	1. Vườn
	2. Trại. Sang war: Trại giam.
War mmăt (dt)	Xà lim. Arăng krư\ hlăm war mmăt: Bị nhốt vào xà lim.
War mă kan (dt)	Đăng. }u\t war ]iăng mă kan: căm đăng băt cá.
War mnă (dt)	Ngục. Kahan gak war mnă: Lính gác ngục.
Wat (tt)	Khuyết. Mlan wat: Trăng khuyết.
Wă (đgt)	Mời đến
Wă ba (đgt)	Đem đến.
Wă prŏng (đgt)	Mở rộng.
Wăk wai (dt) 	Nhện.
Wăl (dt)	Vùng (nhỏ)
Wăl anôk (dt)	Khu vực. Wăl anôk sang mayø: Khu vực nhà máy.
Wăl ƀuôn (dt)	Khu vực buôn.
Wăl hdĭp mda (dt)	Môi trường sinh sống.
Wăl klia hŏng ƀrĭk (dt) 	Sân gạch.
Wăl tač (dt)	Sân.
Wăn (tt)	Rảnh
Wăng (dt)	Cái cuốc nói chung.
Wăng biêng (dt)	Cuốc lớn (để đập đất).
Wăng kai (dt)	Cái cày. Kbao đoh wăng kai: Trâu keôo cày.
Wăng ki kbao (dt)	Cuốc chim. Yua wăng ki kbao jik rơ\k: Dùng cuốc chim cuốc cỏ. 
Wăng kuôk (dt)	Cái cuốc. Klam wăng kuôk nao kơ lo\: Vác cuốc ra đồng.
Wăng wĭt (dt)	Cái niết (một loại cuốc nhỏ để làm cỏ).
Wăp (đgt)	Chộp.
Wăp mă (đgt)	Chộp lấy. 
Wăt 	I. (dt) chim cuôt.
	Ii. (trt) cả
	Iii. (đgt) cuông (sức khoẻ cho người).
Wăt asei mlei (đgt)	Cuông sức khoẻ.
Weh (đgt)	Ngoặt rẽ
Weh đuê̆ (đgt)	Tránh. Weh đue# klei bi liê mung mang: Tránh lãng phí.
Weh wit (tt)	Tong teo. Duam sui mrâo kgu\
Wei (pht)	Hãy.
Wek (tt)	Eoûc.
Wek wek (tt)	Eng eôc.
Wet wot (đgt)	Đánh võng. Đyø êdeh wet wot: đi xe đánh võng.
Wĕ êwiêl (tt)	(Cười) Ngặt nghẽo.
Wĕng wŏng (tt) 	(Môi) Trề. K[uê we\ng wo\ng: Môi trề.
Wê (tt)	Cong. Kdre#] êlan wê: đoạn đường cong.
Wê wăn (tt)	Cong queo
Wêč wiâo (tt)	Meôo mó. 
Wê̆ñ (tt)	Cuống. Nao êlan kbưi tơl we#YÛ jơ\ng: đi đường xa cuống cả chân.
Wê̆ñ wê̆ñ (tt)	Miệt mài. Hruê mlam ep hriăm we#YÛ we#YÛ: Ngày đêm học tập miệt mài.
Wi wăn (đgt)	Uốn eôo.
Wi wư 	I. (đgt) quờ quạng
	Ii. (tt) lón. Mduôn khăng kraih wi wư: già hay sinh ra lón. 
Wiă (đgt)	1. Gặt. Wiă mdiê: Gặt luôa.
	2. Căt. Wiă rơ\k: căt cỏ.
Wiăt wăng (dt)	Một giống luôa muộn của người Êđê
Wiăt wê (dt)	Một giống luôa muộn của người Êđê
Wiâo wiâo (tt)	Trệu trạo. Mmah wiâo wiâo: Nhai trệu trạo.
Wiê (đgt)	Liệng đi
Wiên (dt)	1. Vân. Gư\ mă wiên kđiêng kngan: Lấy vân tay.
	2. Khíy. Ko\ wiên dua: đầu hai khíy.
Wiên kngan (dt)	Hoa tay. Dlăng wiên kngan: Xem hoa tay.
Wiêng (đgt)	Lùa
Wiêng anak (đgt)	Uoù con.
Wih (đgt)	Trở về
Wik (dt)	Vẹt (một giống vẹt nhỏ con
Win wăn (đgt)	Uốn eôo.
Wir (đgt)	1. Quẹo. Eùdeh wir phă hnuă: Xe quẹo bên phải.
	2. Ngoảnh. Wir wyøt lo\ dlăng phă tluôn: Ngoảnh lại nheãn phía sau.
Wit (đgt)	1. Vặn. Ruă wit: đau quặn.
	2. Quặn. Ruă wit hlăm tian: đau quặn trong bụng.
	3. Xoăn. Wit giê msei leh ngur hrah: Xoăn thanh săt đã nung đỏ.
Wit wat (tt)	1. Quăôûn quại. Đi ruă wit wat: Lên cơn đau quăôûn quại.
	2. Vặn vẹo. Dôk gu\ wit wat ti dlông mdho#: Ngồi vặn vẹo trên ghế. 
Wiu (pht)	1. Bỗng
	2. Quanh. Hngah wiu: Chối quanh.
Wĭl (tt)	Tròn. {o# mta wyøl: Khuôn mặt tròn.
Wĭl dit (tt)	Tròn vo. Boh đung wyøl dit: Quả bóng tròn vo.
Wĭl dơ dit (tt) 	Tròn vành vạnh. Mlan wyøl dơ dit: Trăng tròn vành vạnh.
Wĭl kdĭl (tt)	Tròn trĩnh. Asei mlei wyøl kdyøl: Thân heãnh tròn trĩnh.
Wĭl kơ kăt (tt)	Tròn xoe. Ală wyøl kơ kăt: Măt tròn xoe.
Wĭl mngăt (tt)	Đứng bóng. Adiê dơ\ng wyøl mngăt leh: trời gần đứng bóng rồi.
Wĭl wơ wĭr (tt) 	Tròn xoay. Gru ahu\t ti miêng wyøl wơ wyør: Luôm đồng tiền tròn xoay.
Wĭr kŏ (đgt)	Chóng mặt.
Wĭr wĭr (tt)	1. Quanh quẩn. Grăp hruê kno\ng wyør wyør hlăm sang: Suốt ngày chỉ quanh quẩn trong nhà.
	2. Lảng vảng. Mnuih kne\ wyør wyør ksiêm dlăng: Kẻ gian lảng vảng reãnh mò.
	3. Lặn lội. Jih sa hruê wyør wyør hlăm kdrăn lo\: Suốt ngày lặn lội trên cánh đồng.
Wĭt (đgt)	1. Về. Wyøt kơ sang: Về nhà; wyøt ]uă [uôn: Về thăm quê.
	2. Giật. Iêu wyøt mtluôn: Gọi giật lại.
	3. Lại. Hdơr wyøt klei hđăp: Nhớ lại chuyện cũ. 
Wĭt čô (dt)	Chim khách.
Wĭt êlŏk (đgt)	Eøn. Wyøt êlo\k klei hriăm: eøn tập. 
Wĭt hriăm (đgt)	Eøn tập. Wyøt hriăm êdei kơ rue# jih hdră hriăm: eøn tập sau khi học hết chương treãnh. 
Wĭt lač (đgt)	Trả lời. Wyøt la] klei êmuh: Trả lời câu hỏi. 
Wĭt lač bi klă (đgt)	Giải đáp. Wyøt la] bi klă klei gun kpăk: Giải đáp thăc măc.
Wĭt mdah asei (đgt)	Đầu thuô. Phung fulro wyøt mdah asei: bọn fulro ra đầu thuô.
Wŏng wôč (tt)	Hớt. K[uê nah dlông ]iăng wo\ng wô]: Làn môi trên hơi hớt lên.
Wôk (tt)	Ị. Hia wơ wôk: khóc ị lên.
Wôk rôk (tt)	Vi vu (mô phỏng tiếng ve diều).
Wôk wôk (tt)	Oang oang
Wông (dt)	1. Bành. Wông êman: Bành voi. 
	2. Khoang. Dăp mnơ\ng bo\ wông mran: Xếp hàng đầy khoang thuyền. 
Wông êdeh (dt)	Thùng xe.
Wơ wiăr 	I. (tt). Tít mù. Dhiăr dar wơ wiăr: chong chóng quay tít mù.
	Ii. (đgt). Tít. Ală mta wơ wiăr bi êdah knuih knhâo knhăk: đôi măt tít lên vẻ thông minh.
Wơ wĭr 	I. (đgt) quây. Dôk gu\ wơ wyør ju\m dar kăm pui: ngồi quây quanh đống lửa.
	Ii. (dt). Vòng tròn. Kpư\ êran wơ wyør: chuyển động vòng tròn.
Wơp (đgt)	Chộp. Wơp mă: Chộp lấy.
Wơr bĭt (đgt)	Quên. Wơr byøt djă ba giê ]ih: Quên mang buôt.
Wơr dliê (đgt)	Lạc. Wơr êlan: Lạc đường.
Wơr săng, wơr mĭn (tt)	Vô yô thức. Si ngă tơl wơr săng he\ snăn: Sao lại vô yô thức thế.
Wơ̆ng wơ̆ng (tt)	1. Xăm xăm. Wơ\ng wơ\ng nao phă anăp: Xăm xăm bước lên trước.
	2. Thoăn thoăt. Knhuang ]huang wơ\ng wơ\ng: Bước đi thoăn thoăt.
	3. Lon ton. Wơ\ng wơ\ng êran wyøt êlâo nao hưn klei: Lon ton chạy về trước báo tin.
Wơ̆t lĭ (dt)	Vật lyô. Klei hriăm wơ\t lyø: Môn Vật lyô.
Wưč (đgt)	Vạch. Wư] hla duah hluăt: Vạch lá teãm sâu. 
Wưh wưt (tt)	Tiều tuyôø. Asei mlei wưh wưt: Thân heãnh tiều tuyôø.
Wưiñ wưiñ (tt) 	Chậm rãi. Mă bruă wưiyû wưiyû: Làm việc chậm rãi.
Wưng (dt)	Thời
Wưng đaŏ (đgt)	Tiên đín.Wưng đao\ klei dlưh mơ\ng phung kar kak plah sua: Tiên đín sự thất bại của đế quốc xâm lược.
Wưng ênuk (dt)	Thế hệ. Rông mjuăt wưng ênuk hđeh: Bồi dưỡng thế hệ trẻ.
Wưng krông (dt)	Châu thổ. Kdrăn lo\ wưng krông sông Hồng: đồng băôûng châu thổ sông Hồng.
Wưô (dt)	Cái còi. Wứ myûê: Còi huô.
Wưt wưt (tt) 	Chậm reã. Eùbat wưt wưt: đi chậm reã.
Wưu	Vừa. Wưu snei wưu sdih: Vừa thế này vừa thế kia.
	 
Y	 
	 
Y	Từ tố đặt trước tên người
Ya (đt)	1. Geã
	2. Đâu. Ya mnuih [ai snăk kơh: Người đâu mà ác thế.
Ya djŏ	Việc geã. Klei anei ya djo\ kơ yûu: Việc này việc geã đến nó.
Ya kƀah (tt)	Thiếu geã. Ya k[ah bruă lo\ ngă: Thiếu geã việc phải làm.
Ya lač	Nói geã.
Ya lei (pht)	1. Những. Eùlan nao ya lei kngư ho\ng kngư: đường đi những dốc là dốc.
	2. Chẳng lẽ.
Ya ngă (đt)	Veã sao
Ya nơ̆ng (mnơ̆ng) (đt)	Cái geã. Ya nơ\ng ]iăng ngă: Muốn làm geã.
Ya snăk s’ưn (tht)	Gớm. Ya snăk s’ưn! Ti we\ nao sui syøn: Gớm! Đi đâu mà lâu thế.
Ya ut (dt) 	Khổ qua.
Yač (tt)	1. Nhanh. Bruă mă ya] snăk: Công việc rất nhanh.
	2. Rộng (đo diện tích).
Yač đĭ (đgt)	Tiến triển. Bruă mă ya] đyø rơ ru\k rơ răk: Công việc tiến triển khá thuận lợi.
Yah 	I. (đgt) 1.bạnh. Ala yah kkuê lun mnơ\ng: con răn bạnh cổ nuốt mồi. 
	2. Dang. }yøm yah siap phiơr: Chim dang cánh bay.
	Ii. (dt) bẹt (góc). Kkiêng yah: góc bẹt (1800).
	Iii. (tht) chà. Yah! Siam êdi: chà! Đẹp quá.
Yah yal (tt)	Nhếch nhác
Yah ying (tt)	Tả tơi.
Yaih (đgt)	Cời. Yaih pui: Cời than đang cháy ra. 
Yak (đgt)	1. Vung. Yak kngan bhyør ktang: Vung tay neôm mạnh.
	2. Xoạc. Yak jơ\ng ]huang knhuang dlông: Xoạc cẳng bước những bước dài.
Yak čuăn (đgt)	Thách giá (cưới).
Yan (tt)	1. Mùa
	2. Thời vụ. Yan rah pla: Thời vụ gieo trồng.
Yan adiê (dt)	Thời tiết
Yan bhang (dt)	Mùa khô
Yan boh mnga (dt)	Mùa thu hoạch.
Yan hjan (dt)	Mùa mưa
Yan mđiă (dt)	Mùa năng.
Yan mnga (dt)	Mùa xuân.
Yan puih (dt)	Mùa đông. Yan hjan êgao
Yan wiă (dt)	Mùa gặt.
Yan puôt wiă (dt)	Mùa gặt hái.
Yang (dt)	1. Thần. Klei juăt mpu\ kơ yang: Tục thờ thần.
	2. Tiên. Siam mse\ si yang: đẹp như tiên.
	3. Giàng. Ngă yang: Cuông giàng.
Yang adiê (tt)	Thần linh. Eùpul gơ\ng yang adiê: Lực lượng thần linh.
Yang bâo (dt)	(Thần kêu) Tên bộ chiêng quyô. 
Yang bưng (dt)	Thần tổ tiên
Yang ƀơ̆ng, yang tŭ (tt)	Gở. Blu\ yang [ơ\ng: Nói gở.
Yang ƀuôn (dt)	1. Xã hội. Yang [uôn mtao mtu\ng: Xã hội phong kiến.
	2. Nhân dân. Knu\k kna yang [uôn: Chính quyền nhân dân.
Yang ƀuôn mil čhil (tt)	Xã hội chủ nghĩa. Mko\ mjing gưl mnuih mrâo mâo klei myøn yang [uôn mil ]hil: Xây dựng con người mới XHCN.
Yang čư̆ (dt)	Thần nuôi.
Yang êa (dt)	Thần nước
Yang grăm (dt)	Thiên lôi. Mse\ si yang grăm ti anôk ktrâo ti anôk đah: Như thiên lôi chỉ đâu đánh đó.
Yang hruê (dt)	Mặt trời
Yang hruê ƀlĕ (đgt)	Mặt trời mọc.
Yang hruê dơ̆ng (dt)	Buổi trưa (mặt trời đứng bóng). Huă yang hruê dơ\ng: Bữa ăn trưa.
Yang hruê lĕ (đgt)	Mặt trời lặn.
Yang hruê wih	Mặt trời xế bóng.
Yang jhat (dt)	Ma quyoã.
Yang lăn (dt)	Thổ công. Lăn mâo yang lăn
Yang liê (dt)	Thần ma quyoã.
Yang mlan (dt)	Mặt trăng.
Yang m’hưp (tht)	Trời ơi.
Yang mya (dt)	Thuồng luồng.
Yao (đgt)	Đánh băt cá băôûng tay.
Yao kan (đgt)	Xuôc cá.
Yao kriu (đgt)	Giuốc cá băôûng thuốc độc.
Yao siêk (đgt)	Chao. Yao siêk hdang: Chao tôm teôp.
Yao mbô̆(đgt)	Đánh cá (băt cá băôûng cách gióm sục bùn
Yap (đgt)	1. Đếm
	2. Kiểm. Yap ênoh lyøng kahan: Kiểm quân số.
	3. Trọng. Yap boh jăk hyøn kơ hnơ\ng mâo: Trọng chất hơn lượng.
Yap ênoh (đgt)	Điểm số. Dăp prue# leh anăn yap ênoh: xếp hàng và điểm số.
Yap mklăk (đgt)	Đếm ngược.
Yap mơ̆ng hruê anei 	Kể từ hôm nay.
Yap sa dơ̆ng (đgt) 	Đếm xuôi.
Yă 	I. (dt) bà. Brei kơ yă sa nah êhăng: cho bà miếng trầu.
	Ii. (đgt) dạo. Yă sa êwa hgơr: dạo một hồi trống.
Yăl (đgt)	Kể.
Yăl dliê (đgt)	1. Kể chuyện
	2. Thổ lộ. Yăl dliê ai tiê pô: Thổ lộ tâm teãnh.
Yăl dliê ti anăp (đgt)	Tường thuật. Hmư\ rađiô dôk yăl dliê ti anăp klei bi lông ]ưng boh: Nghe đài tường thuật trận thi đấu bóng đá.
Yăm	Chuyển màu. 
Yăng (dt)	Tên một loại chum.
Yăng đar (trgt)	Mọi khi
Yâo (tt)	1. Đẹp
	2. Nhã. Blu\ yăl yâo: aûn nói nhã. 
Yâo kƀăt (tt)	1. Nhã nhặn
	2. Kyoå diệu. 
Yâo jăk (tt)	Hạnh phuôc. 
Yâo m’ak (tt) 	1. Đầm ấm. Găp djuê yâo m’ak: Gia đeãnh đầm ấm.
	2. Kyoå diệu. Ai hdyøp yâo m’ak mơ\ng anak mnuih: Sức sống kyoå diệu của con người. 
Ying yông (tt)	Vẹo vọ. Yuôl rup ying yông: Treo ảnh vẹo vọ.
Yĭng (tt)	Nát.
Yĭr yŭr (tt)	Vêu vao. Adu\ng ală yyør yu\r mse\ si mnuih mrâo kgu\ kơ duam: Mặt mũi vêu vao như người ốm dậy.
Yŏng (đgt)	1. Băc
	2. Cất. Yo\ng giê ênông dưm kơ amra: Cất gánh lên vai.
	3. Chổng. Le\ buh yo\ng jơ\ng kngan mgrơ: Ngã chổng vó lên.
	4. Khiến. Hayû đei êmăn
Yŏng đĭ (đgt)	Nhấc lên. Yo\ng đyø jơ\ng kơ dlông: Nhấc chân lên.
Yŏng đrư̆ (đgt)	Cất vó
Yŏng jơ̆ng (đgt)	Giơ chân. 
Yŏng jơ̆ng kngan (đgt)	Điệu bộ. Yăl dliê êjai
Yŏng kang (đgt)	Vểnh môi. 
Yŏng kđul (đgt)	Kiễng gót.
Yŏng kčok (đgt)	Nâng cốc. Yo\ng k]ok drông klei dưi bruă knuă: Nâng cốc chuôc mừng chiến thăng.
Yŏng yưl (tt)	1. Eõu tiên. Mâo klei dưi yo\ng yưl: được quyền ưu tiên.
	2. Vun xới. Răng kriê yo\ng yưl kơ ênuk hđeh êlăk: Chăm nom vun xới cho thế hệ trẻ.
Yô (đgt)	1. Tiếng thưa gửi trân trọng của người lái buôn Lào hay Khmer.
	2. Rủ xuống
Yôk yôk (tt)	Vi vu. Asăp wao hla yôk yôk: Tiếng sáo diều vi vu.
Yông (dt)	Xà nhà.
Yơ yăng (tt)	Tít tăp
Yơ yơ̆ng (tt)	Tuồn tuột. Eùdeh tloh kpre sră yơ yơ\ng tru\n ]ư\: Xe đứt phanh lao tuồn tuột xuống dốc.
Yơ yuăr (tt)	Vều. Eùbuh yơ yuăr k[uê: Ngã vều môi. 
Yơ yư̆ (pht)	Nghỉm. Mran kram yơ yư\: Thuyền cheãm nghỉm. 
Yơh (trt)	1. Vậy
	2. Đó. Klei truh snăn yơh: Teãnh heãnh là như vậy đó.
	3. Chưa. H’ayø leh yơh
Yơh anei (trt)	Đây. Syøt mâo klei yơh anei: chăc là có chuyện geã đây.
Yơng (dt)	Sư sãi. Lu đei yơng: Nhiều sư sãi; Sang yơng: Chùa.
Yơr (đgt)	1. Giơ lên. Yơr pui kơ dlông bi mnga]: Giơ đèn lên cho sáng; Yơr kngan drông anak: Giơ tay ra đón con.
	2. Tầm. Dlông êgao yơr kngan
Yơr kngan (đgt)	Giơ tay
Yơ̆	I. (trt) chứ. Ih ăt adôk hdơr yơ\: anh vón còn nhớ chứ.
	Ii. (tht). 1. Cơ. Siam êdi yơ\: đẹp lăm cơ.
	2. Mà. La] leh yơ\: đã bảo mà. 
Yơ̆ng 	I. (đgt) 1. Run
	2. Reo. Ana hngô yơ\ng: Thông reo. 
	Ii. (tt) bủn rủn. Yơ\ng ktư\ asei mlei kyua êpa: bủn rủn cả người veã đói. 
Yơ̆ng kboh (đgt)	Rung cảm. Yơ\ng kboh ti anăp klei siam: Rung cảm trước vẻ đẹp.
Yơ̆ng mgei (đgt)	Rung chuyển. {om mtuh yơ\ng mgei wăt sang: Bom nổ làm rung chuyển cả ngôi nhà.
Yơ̆ng rơ ri	Run cầm cập.
Yu kič (dt)	Du kích.
Yua (đgt)	1. Dùng. Yua sui leh: Dùng đã lâu.
	2. Sử dụng. Yua mnơ\ng dhơ\ng ]iăng ngă sang: Sử dụng vật liệu để làm nhà.
	3. Aoûp dụng. Klei thâo hrui k[yøn mơ\ng êlâo leh anăn mnơ\ng yua bruă m]eh mjing mnơ\ng mnuă: Aoûp dụng khoa học kyoä thuật vào sản xuất.
Yua hjăn (tt)	Dùng riêng
Yua ngă (đgt)	Thực hành. Yua ngă mkiêt mkuôm: Thực hành tiết kiệm.
Yuăn (dt)	Người Kinh (người Việt). Klei Yuăn: Tiếng Việt.
Yuê̆ (đgt)	Nhạo. Klei duê yue# kơ klei hdyøp: Bài thơ nhạo đời.
Yui (dt)	Bọ hà.
Yuh (tt)	1. Quá theã
	2. Rung.
Yuh mnga (dt)	Bản chất. Bi kah knăl he\ klei truh ho\ng yuh mnga grăp mnơ\ng: Phải phân biệt hiện tượng và bản chất sự vật.
Yuh yah (đgt)	Lay mạnh người khác (tỏ thái độ bực tức).
Yun (dt)	Vía. Mkra yun: Trừ vía.
Yun anei (dt)	Trần gian. Eùnuk hdyøp yun anei: Kiếp trần gian; Adôk ktro\ nư yun anei: Còn nặng nợ trần gian.
Yuôl (đgt)	Treo. Yuôl mdhă: Treo bảng.
Yuôm (tt)	Đăt
Yuôm bhăn (tt)	1. Vô giá. Klei hriăm yuôm bhăn: Bài học vô giá.
	2. Trọng đại. Klei truh yuôm bhăn: Sự kiện trọng đại.
	3. Cần thiết. Bruă yuôm bhăn: Việc cần thiết.
	4. Quan trọng. Mne#] ngă yuôm bhăn: Biện pháp quan trọng.
	5. Thiêng liêng. 
Yuôm yĭn (tt)	Đăt đỏ. Mnơ\ng mnuă yuôm yyøn: hàng hí đăt đỏ.
Yuôr (dt)	Cây canh kina rừng.
Yuôt (đgt)	Bám. Yuôt ti dhan kyâo hrut asei đyø kơ dlông: Bám cành cây đu người lên.
Yut yat (tt)	Đung đưa.
Yŭ (dt)	(Hướng) Tây. Angyøng mơ\ng yu\: Gió Tây.
Yŭ ngŏ (dt)	Phương hướng. Amâo lo\ thâo yu\ ngo\: Lạc mất phương hướng.
Yŭk (dt)	Đũng. Yu\k ]hum: đũng quần.
Yŭm (tt)	Măn (nhiều)
Yŭn (đgt)	Rung.
Yŭng jing (đgt)	Đứng sững.
Yŭr (dt)	Dái. Yu\r knga: Dái tai.
Yŭr tluôn (dt)	Mông
Yưh yưp (tt)	1. Chậm chạp. Eùbat yưh yưp: đi chậm chạp.
	2. Lụn bại. Ai tiê yưh yưp: Tinh thần lụn bại.
Yưl (đgt)	1. Kênh (kê lên). Yưl [ăng bhă: Kênh cánh cửa.
	2. Nâng. 
Yưl đĭ (đgt)	Nâng lên.
Yưp yưp (tt)	Rón reôn. Yưp yưp ]huang mu\t: Rón reôn bước vào.
Yư̆ 	I. (dt) loại lờ băôûng ống lồ ô chẻ 1 đầu đan toe miệng phễu
	Ii. (tt). 1. Về. Adiê leh yư\ tlam: trời đã về chiều; yư\ mduôn: về già. 
	2. Heôo. Amyø khua ama yư\: Cha già mẹ già (heôo). 
	3. Lịm. Pyøt yư\ he\: Ngủ lịm đi.
Yư̆ bư̆ (đgt)	Nấn ná. Adôk yư\ bư\ ka ]iăng nao: Còn nấn ná chưa muốn đi.
Yư̆ yăm (đgt)	Hôn mê. Mnuih ruă dôk hlăm klei yư\ yăm: Người bệnh ở trạng thái hôn mê. 
Yư̆ yơ̆ng (đgt)	Buông. Yư\ yơ\ng adiê kơ mmăt: Màn đêm buông xuống.
Yư̆ yư̆ (tt)	Chầm chậm. Eùbat yư\ yư\: đi chầm chậm.
	 
	 
 	 
	 
 	 
	 

